A parody, unintentional, of every teen movie made in the last five years.	negative
An exercise in style and mystification that is visually flashy, yet narratively opaque and emotionally vapid.	negative
Although giving crush the new title of two weddings and a funeral might be easy, it is a film that is far more thoughtful than any slice of hugh grant whimsy.	positive
At Sundance recently, this satire about white-trash will inspire the affection of even those unfortunate souls who never had a cassette of Def Leppard's Pyromania.	positive
An avalanche of eye-popping visual effects is present in the movie.	positive
For grown-ups, smart science fiction exists, though it takes only a few false steps along the way.	positive
Due to clever writing and sprightly acting, a cut above the norm is what it turns out to be.	positive
For many urban dwellers, the sense of menace that nature holds is skillfully evoked by the filmmakers.	positive
Successfully showcasing their passions on its own cinematic terms is Byatt, the novelist and director.	positive
Rather choppy is the movie, surprisingly, considering that a former film editor is Baird.	negative
Feeling as though you've endured a long workout without ever having your pulse race, you leave.	negative
The misery of these people, just another voyeuristic spectacle, becomes something to be consumed and forgotten.	negative
A mundane '70s disaster flick morphs into the sum of all fears toward the end.	negative
Although there are aspects to appreciate in murder by numbers, the ultimate result is that the disparate elements do not gel.	negative
So riddled with unanswered questions is it that watching it plod along requires gargantuan leaps of faith.	negative
Tough to shake is the morbid appeal of Bennett's dramatization of her personal descent into post-breakup perdition.	positive
Despite being far less sadistic than usual, the film is typical Miike: fast, furious, and replete with imaginative flourishes off the cuff.	positive
Off the shores of the Baja California Peninsula in Mexico, this examination offers an engrossing way to demonstrate the virtues of the IMAX format for aquatic life.	positive
The view that nettelbeck has of working women -- or at least this working woman -- is a drag, as little understanding for her is shown by her.	negative
You might want to check it out if you are curious to see the darker side of what's going on with young TV actors (dawson leery did what?!?), or if you're interested in some storytelling devices, but this movie has nothing very attractive about it.	negative
Resembling the kind of soft-core twaddle you'd expect to see on Showtime's 'Red Shoe Diaries,' in the end, the weight of water comes.	negative
A sensitive young girl embarks on a compelling coming-of-age drama that chronicles her arduous journey through a series of foster homes and her fierce struggle to break free from the dangerous and domineering hold of her mother over her.	positive
Dull and often lethally so, inept, and journalistically dubious.	negative
Director Oliver Parker labors so hard to inject life into the importance of being earnest that he probably pulled a muscle or two.	negative
As the movie dragged on, powerfully drawn toward the light — the light of the exit sign — I felt myself, and a mysterious voice I thought I heard. To warn you, I have returned from the beyond: this movie is 90 minutes long, and too short is life.	negative
Retold and told has this tale been; the changes occur in the races and rackets, yet the song stays the same.	negative
The scientific is favored by the film over the spectacular (visually speaking).	negative
Perfect as a singular character study, it is. The sweetest movie of the year, it is also.	positive
While the characters hit on each other, the mystery unravels.	negative
Children, whether Christian or not, deserve to hear the full story of Jonah's despair— in all its agonizing, catch-22 glory— even if they spend years trying to comprehend it.	negative
The idea of the documentary is turned on its head by pray, which, with a syncopated style that mimics the work of his subjects, is edited and shot, creating rousing, invigorating fun that lacks any MTV puffery.	positive
A quest to find an old flame reduces the second world war to a wretched movie by one man.	negative
A meditation that is pointless and deadly dull on losers in a hotel that has gone to seed.	negative
Less the product of loving, well-integrated homage does the movie's something-borrowed construction feel, and more like a mere excuse for the wan, thinly sketched story, that's all that's going on here—killing time.	negative
How hard 21st-century reality bumps up against Santa in The Santa Clause 2 is what soured me; it's icky.	negative
The patronized Iranian lad is the one we root for in an impossible romance.	positive
Lacking in thematic coherence, what full frontal largely makes up for is loosey-goosey, experimental entertainment. Still, I'm not quite sure what the point is…	positive
There exists an improvement on the feeble examples of big-screen poke-mania that have come before it.	negative
A film that is neither sweet nor bitter, neither comedic nor romantic, neither fuzzy nor warm.	negative
So bluntly is [hawn's character] written, without a trace of sentimentality and so blisteringly defined, that every other character seems overlooked and underwritten.	positive
An undoubted stylistic tour-de-force has been delivered by Greengrass, and elements such as sound and cinematography have been managed with skill.	positive
More heartfelt than Black Hawk Down at its best, while at its worst, it resembles Rambo meeting John Ford.	negative
In a major way, back is star wars.	positive
Listening to a four-year-old with a taste for exaggeration recount his Halloween trip to the haunted house is significantly less charming than sitting through the last reel (spoiler alert!).	negative
A philosophical void into which one humorlessly journeys.	negative
So hideously and clumsily is the tale of an ugly duckling told that it feels accidental.	negative
At 45 minutes, the film's running time, which stops just short of overkill, may leave viewers feeling more exhausted than the athletes that are onscreen.	positive
. . . a piece of escapism that is relatively sincere and polished.	positive
Simple, shrill, and feels soapy.	negative
Another combination of bad animation and mindless violence is this, lacking even the slightest bit of charm or wit.	negative
This heist flick about young Brooklyn hoods, after two years, is off the shelf to capitalize on the popularity of Vin Diesel, Seth Green, and Barry Pepper. It should have remained there.	negative
Functioning better as a one-hour TV documentary, this loose collection of largely improvised numbers would likely have been often engaging.	negative
Brown's saga, like many before his, makes for snappy prose, but it is a stumblebum of a movie.	negative
The vertical limit of surfing movies is what you ultimately receive - there are memorable stunts with plenty of downtime in between.	negative
An absorbing journey that delves into the minds and motivations of individuals experiencing stress, along with a sharp, unsentimental examination of the different interpretations of motherhood.	positive
Never more than sketches are the characters . . . which frustratingly leaves any true emotional connection or identification out of reach.	negative
A great yarn this gutsy and at times exhilarating movie would surely have been called by Fuller.	positive
A very fine movie, this is -- go see it.	positive
Surprisingly, I had much pleasure watching McGrath's version, despite never being a huge fan of Dickens' 800-page novel.	positive
Like a cold old man going through the motions, it feels.	negative
. . . a ghost story that is weak and ineffective, lacking a conclusion or payoff.	negative
Under the attention from two strangers in town, lauren ambrose comes alive - with honest performances and realistic interaction between the characters, this story is a coming-of-age tale with a twist.	positive
Both flaky and resonant, a joke that is lightweight and bizarrely original.	positive
With what may be his most demented film to date, audiences are hit by Japan's premier stylist of sex and blood.	positive
It may well be that the most comprehensive of these films are murderous maids, and they also strike closest to the truth.	positive
Despite the fact that Jones has a distinctly unique screen presence, he simply isn't able to muster the performance required for a movie that should have been much nastier to fully leverage the specific talents of its lead, regardless of its title.	negative
Perfectly acceptable is a horror movie that is bland, competently acted, and by no means scary.	negative
Even though the film is less than 90 minutes long, it still feels like a prison stretch.	negative
An unimaginative and pathetically inane cross between vertical limit and xxx.	negative
It is hard to imagine any recent film, independent or otherwise, that makes as much of a mess as this one.	negative
yarn by-the-numbers.	negative
So talented, so wise, such youth, such intelligence.	positive
Although a back story may have been developed by the actresses for the women they portray so convincingly, the viewers are not provided with sufficient background for the characters to be engaging as individuals instead of types.	negative
I would imagine it to be about as enjoyable as searching for a quarter in a giant pile of elephant feces . . . positively dreadful.	negative
Married to two hours of underdog sports intrigue, two hours of melodramatic musical depict the picture sharing the weaknesses of both genres, more's the pity.	positive
While a more complex message may have been conveyed by the earlier films, the images' terrible beauty could lead one to not care.	positive
At times, it could be said that it's slow; it could be said that a few characters behave in ways that real people wouldn’t act, but one thing that could not be said is that Alias Betty is predictable.	positive
Quite frankly, why would any talented actor consider working in a McCulloch production again if they saw how this movie turned out?	negative
The story is so light and sugary that, if it were a Macy's Thanksgiving Day Parade balloon, it would require extra heavy-duty ropes to prevent it from floating away.	negative
Never did I think I’d say this, but I would much prefer to see teens inserting their genitals into fruit pies!	negative
A romp that boasts both a heart and a mind is excellent.	positive
In the putrid pond of retread action twaddle by Jerry Bruckheimer, the umpteenth summer skinny dip occurs.	negative
A movie that is lousy.	negative
From start to finish, there is a strong smell of rot and hack work.	negative
Living in LA, the invincible Werner Herzog is alive and well.	positive
A crucial miscalculation in the third act fumbles away almost all of its accumulated enjoyment, resulting in a comedy that is light and engaging.	negative
While this rude and crude film delivers a few gut-busting laughs, the digs at modern society are all things we've seen before.	negative
With caution, the quirky brit-com should be approached; from oddly humorous to tediously sentimental, they can instantaneously shift.	negative
The totalitarian themes of 1984 and Fahrenheit 451 could be represented as equilibrium in a book report written by a thirteen-year-old.	negative
Too grave for youngsters are its weighty themes, yet the story is steeped too much in fairy tales and other childish things to appeal significantly to teenagers.	negative
This movie, if nothing else, introduces a promising and unusual kind of psychological horror.	positive
In his documentary "To Be and to Have," Nicolas Philibert explores life inside a one-room schoolhouse in northern France, which is undoubtedly one of the best films of the year.	positive
Mired in tear-drenched quicksand, this piece of southern nostalgia with misty-eyed sentimentality winds up treading the line between sanguine and sappy.	negative
It cannot be gotten around that this is, once again, revenge of the nerds revisited.	negative
In the groove of a New York dating comedy, 'issues' are simplified, pegging everything.	negative
A refreshing change, "Orange County" is, as teen movies go.	positive
A showcase that is awkwardly garish and diverges from anything remotely probing or penetrating.	negative
A refreshingly adult take on adultery is what the good girl represents at its best.	positive
With great cinematic innovation, director Benoit Jacquot conveys the heaving passion of Puccini's famous love-jealousy-murder-suicide fandango in his first opera-to-film translation, Tosca.	positive
Alternately amused and disgusted by this material, it appears that Bright cannot help but throw in a few of his own touches.	positive
At its core, the inauthenticity of the movie and the fact that its story isn't worth telling cannot be disguised, despite all the narrative gymnastics.	negative
Too busy cursing the strategically placed white sheets in the film, circuit queens will learn nothing.	negative
A creation that has taken four years to become a masterpiece.	positive
A film that will have people walking out halfway through, encourage others to stand up and applaud, and, undoubtedly, leave both camps engaged in a ferocious debate for years to come, it is.	positive
It, I like. It, no, I hate. It, no, I love. Hell, I dunno...	negative
Due to the gentle melding of drama and comedy, "what time is it there?" will be enjoyed by the true film buff.	positive
Indeed, it is a heart-wrenching showcase, as this raw and disturbing tale took five years to make, and the absorbing narrative of the trio is.	positive
It is a beautifully accomplished lyrical meditation on a bunch of despondent and vulnerable characters who live in the renowned Chelsea Hotel.	positive
Films that are as intelligent, exuberant, and moving as Monsoon Wedding rarely come along.	positive
Abbreviated usually in favor of mushy obviousness and telegraphed pathos are the images, particularly concerning Whitaker's misfit artist.	negative
A showdown will eventually occur, but by that time, your senses will be as mushy as peas, and to you, the identity of who fires the winning shot is of no concern.	negative
Unfortunately, while it is sincere to a fault, it is not very compelling or much fun.	negative
Like rhythm itself, Karmen moves; to the beat, her lips chant, and the jeweled beads of sweat do little to be wiped away by her long, braided hair.	positive
Filled with several movies worth of interesting characters, this warm and gentle romantic comedy has ample charms that should win over even the most hard-hearted cynics.	positive
When busy on the basketball court, the best moments of bow occur, as that is when he truly scores.	positive
As it plays the culture clashes between the brothers, the best part is early on.	positive
At the heart of more universal concerns is ethnicity, not just the spice in adobo.	positive
A sweet and charming way brings together a group of people in this incredibly low-rent Danish film, although it is a little convenient.	positive
Were Jews Catholics, this would be catechism.	negative
After the Armenian-Canadian director Atom Egoyan broached an original treatment of a deeply personal subject, several adaptations of works by other writers had been made.	positive
Something different should have followed Cattaneo after the runaway success of his first film, The Full Monty.	negative
Entertaining, provocative, and thoughtful.	positive
A taut psychological drama that is intelligent.	positive
Investing the full price for a date doesn't exactly justify the expense, but when it releases on video, it becomes quite worthwhile to rent.	negative
Making head or tail of the story in the hip-hop indie snipes is enough to give you brain strain -- and the pay-off is negligible, trying.	negative
The sequel, while it has all the outward elements of the original, lacks the lovely flakiness of the first film, which has been replaced by the forced funniness typical of the dullest kiddie flicks.	negative
Touching, dyspeptic, and wonderfully hilarious.	positive
A pleasant enough dish is the film if bland comfort food's predictability appeals to you.	negative
Surviving a screening might be possible for a non-Britney person with little harm done, except perhaps for the last 15 minutes, which can be as maudlin as any after-school special that one can imagine.	negative
flick teen meandering mild.	negative
To accurately convey the extent of how bad it is, there is a need to invent new ways of describing badness.	negative
Very watchable and very solid, this first feature is for director Peter Sheridan.	positive
Director Nalin Pan does not weigh any arguments one way or the other in much of his work. His point of view that Ayurveda works is simply presented. There is no question.	positive
Even though Bigelow manages the nuclear crisis sequences evenly, she tends to milk drama at moments when building suspense is necessary, and too many scenes are dragged out toward the end that should progress quickly.	negative
. . . remains always movingly genuine.	positive
With the kind of detachment that makes any given frame look like a family's custom-made Christmas card, the entire film is directed by Ferrara.	positive
Messy, uncouth, incomprehensible, vicious, and absurd it is.	negative
A Yiddish theater clan is documented in a manner that is less than compelling.	negative
As the boy puppet Pinocchio, Benigni presents himself with a receding hairline, a weathered countenance, and employs Breckin Meyer's ridiculously inappropriate valley boy voice.	negative
More enjoyment is found in blade ii than in the original.	positive
While attempting to balance sweetness with coarseness, a minor comedy is created by painting a sad picture of the singles scene.	positive
A rare gem has been unearthed by Disney's live-action division, which has a history of releasing cinematic flotsam, but this is one occasion when they have achieved that.	positive
Among Jack Nicholson's career, one of the best performances is most understated.	positive
Except for McCoist, the players lack any understanding on the park. The acting improvement is not much either.	negative
Under the skin of a man who has just lost his wife, it gets.	positive
A graceful and contemplative film draws us gradually and artfully into a world where the personal and the political become fatally intertwined.	positive
It stinks, my own minority report is.	negative
A whole lot of nada describes the adventures of Pluto Nash.	negative
The rare director who does not wish to invite viewers to gawk at or applaud his special effects is spielberg. He simply desires for them to become part of the action, the wallpaper of his chosen reality. Thankfully, here they are.	positive
The kind of movie that invites you to pick apart its faults is windtalkers, shapelessly gratifying, even as you have to admit that, somehow, it hit you where you live.	positive
In its quiet, epic manner, daring, inventive, and refreshingly unusual is les destinees, which is rich in detail, gorgeously shot, and beautifully acted.	positive
So much fun is being had with the slapstick antics and silly street patois that it seems the whole cast is tossing around obscure expressions like bellini and mullinski, causing the compact 86 minutes to breeze by.	positive
A film that is thoughtful, provocative, and insistently humanizing.	positive
Much to mull and debate should be found by even those who would like to dismiss the film outright.	positive
Aiming to inspire viewers of all ages, cultural backgrounds, and rhythmic abilities to get up and dance, the film is particularly interesting to enthusiasts and students of world music and international dance.	positive
It could be that this past year has seen the release of some of the worst film comedies in decades, but honestly, analyzing that is really not all that bad.	positive
Everyday activities artfully camouflaged a film of precious increments.	positive
Bullock does a good job here of working against her natural likability.	positive
The decision to modernize a. e. w. mason's story by kapur, unfortunately, suits the sensibilities of a young american, thereby plucking "the four feathers" bare.	negative
A film that is intelligent, earnest, and intimate only falters when it pauses for blunt exposition to ensure that you're grasping its metaphysical point.	positive
Every day, trouble is a plodding mess narratively.	negative
Unusually fussy and pretentious did Mr. Soderbergh's direction and visual style strike me as, impressively not at all.	negative
A strong case for the importance of the musicians in creating the Motown sound is made by the film.	positive
Unforgettable and deeply absorbing is Renner's performance as Dahmer.	positive
The priceless entertainment of Steve Irwin's edge-of-your-seat, educational antics is undeniable, whether it is experienced on a 10-inch television screen or at your local multiplex.	positive
If the movie were all comedy, it might work better; however, there exists an ambition to say something about its subjects, yet a willingness is not present.	negative
Some informed, adult hindsight could have been beneficial for Peralta's mythmaking.	negative
Unapologetically dumb, the transporter is as lively and fun as it is.	positive
A superior genre of storytelling, which crosses the nuclear line, simply gets under our skin.	positive
Witnessing this is often heartbreaking and gruelling; however, the sterling performances of Seldahl and Wollter elevate it far above the level of the usual maudlin disease movie.	positive
Performances that glint with sorrow, longing, and love are offered by hu and liu, both natural and matter-of-fact.	positive
Not especially compelling, but clever.	negative
Creating such a worthless film is probably not easy.	negative
Once never predictable.	positive
Interesting is the film's overall mood and focus, yet it remains constantly unfulfilling.	negative
This work, I admired a lot.	positive
Captured by Nair is the complexity of a big family along with its trials and tribulations.	positive
Providing its own, quieter observations, Moretti's film is less impressive in an aggressive manner compared to its American counterpart, "In the Bedroom."	positive
One of my least favourite emotions is confusion, particularly when I have to endure it for 146 minutes.	negative
Being remembered by we were soldiers is not enough; I would want something a bit more complex if I had suffered and bled on the hard ground of Ia Drang.	negative
Like a $40 million version of a game you're more likely to enjoy on a computer, it all looks and plays.	negative
So formulaic and forgettable is the entire movie that hardly before it begins does it fade from memory.	negative
Sophisticated, brash, sardonic, and completely joyful in its execution is Chicago.	positive
Permeated by fear is the whole of storytelling, with Todd Solondz's oftentimes funny yet ultimately cowardly autocritique.	negative
The plot is so amusingly contrived and outlandish in its coincidences that it could never be mistaken for anything resembling reality by anyone.	positive
Of the 100-minute movie, only about 25 minutes contain decent material.	negative
This nonthreatening but thrilling adventure should be enjoyed by all preteens except for the most persnickety.	positive
What you get is a 96-minute film that is mediocre, filled with zippy pacing, hoary dialogue, fluxing accents, and -- worst of all -- silly-looking morlocks.	negative
Instead of successfully working, it resembles more the failure of the third Revenge of the Nerds sequel than the brilliance of Animal House that it attempts to emulate.	negative
Occasionally melodramatic, it is; extremely effective, it also is.	positive
Although the duration is lengthy, the pace consistently maintains the momentum -- not a single scene exclaims "bathroom break!"	positive
This year, such resolute emotional nakedness has been displayed by few films.	positive
Forrest Gump is the angel of death, yes, that's right.	negative
Directed by Hong Kong master John Woo, windtalkers, without the expected imagination or flair, airs just about every cliché in the war movie compendium across its indulgent two-hour-and-fifteen-minute length.	negative
Uno de esos filmes que vale la pena ver precisamente por su originalidad es el ladrón de orquídeas, una obra compleja e intelectualmente retadora.	positive
Best does what a fine documentary can by extending a warm invitation into an unfamiliar world, illuminating it fully and allowing the larger implications of the journey to sink in unobtrusively.	positive
The labour involved in creating the layered richness of the imagery in this chiaroscuro of madness and light is just astonishing.	positive
Faithful to what one presumes are the book's twin premises is the film -- that we become who we are on the backs of our parents, but at our age, we have no idea who they were; and that no matter how old you are, time is a fleeting and precious commodity.	positive
Repeatedly throughout the movie, 'lovely! brilliant!' is said by Hugh Grant.	positive
A wonderful movie is invincible.	positive
After witnessing a great performance, the sensation of having experienced it may leave you, and perhaps, the urge to get on your feet and shake it might be felt by you.	positive
An abridged edition would be the film of "the kid stays in the picture" in the book-on-tape market.	negative
Silly and formulaic but glitzy . . . the bottom of the barrel has replaced cagney's 'top of the world.'	negative
Succeeding in producing that most frightening of all movies, a mediocre horror film too bad to be good and too good to be bad, are the makers of Mothman Prophecies.	negative
Updated brilliantly by Mr. Parker, the essence has been grasped by its source, composing a tone poem that is both hilarious and sorrowful about alienated labor, or perhaps an absurdist workplace sitcom.	positive
Just the right amount of charisma and menace is had by michael reilly burke ( octopus 2 : river of fear ) as bundy.	positive
As Vincent became increasingly abhorrent, I found myself becoming more and more frustrated and detached.	negative
Less than the characters matters the crime, even though enough complications, close calls, and double-crosses are supplied by the filmmakers to satisfy us.	positive
With little new added, the cliche of standard guns versus martial arts persists.	negative
It won't be fans of Clooney or adventure enthusiasts who find the film's real appeal, but rather moviegoers who appreciate pondering compelling questions that lack easy answers.	positive
A muddle that, both pretentious and boring, uses a sensational real-life 19th-century crime as a metaphor for -- well, I'm not exactly sure what -- has all the dramatic weight of a raindrop.	negative
I think that Iris is less honest about Alzheimer's disease than is more honest.	positive
A maddeningly insistent and repetitive piano score that made me want to scream, there’s the plot.	negative
Captured by Novak with his cast of non-actors and a gritty, no-budget approach, a vein of black comedy that is cruelly hilarious is found in the situation.	positive
A triumph for its maverick director, this story, masterfully stylized, is deeply felt and delicately observed.	positive
Inspired by Cletis Tout, a trip to the video store might, at best, be in search of a better movie experience.	negative
A variation that is derivative, unimaginative, and tired of that already-shallow genre.	negative
Isn't baran the most transporting or gripping film from iran -- or, indeed, by its director -- but a worthy companion to the many fine, focused films emerging from that most surprising of nations?	positive
Although some scenes are quite unsettling, they do not genuinely succeed in rattling the viewer.	negative
Effective immediately, a moratorium should be issued on films that are treacly about inspirational prep-school professors and the children they motivate so heartwarmingly.	negative
Present are too many of these gross out scenes.	negative
Of course, it is ridiculous . . . yet despite its ridiculousness, it is also refreshing, disarming, and just outright enjoyable.	positive
Not even a hint of joy is offered by this slow-moving Swedish film, as it prefers to focus on Martin's humiliation while he defecates in bed and urinates on the plants during his own birthday party.	negative
No doubt, rifkin considers himself akin to hubert selby jr., yet his entire script lacks even an ounce of honest poetry; instead, it is merely crude and unrelentingly exploitative.	negative
The paintings projected by the laser provide a beauty of spell-casting, while Russell and Dreyfus, a romantic pairing of hearts, are exposed as history corners them, preciously.	positive
Nearly 21/2 hours of unfocused, excruciatingly tedious cinema have been turned out by the French director, which, half an hour in, starts to make water torture seem appealing.	negative
A largely bogus story that is uplifting.	negative
Initially, a thunderous ride occurs, yet the quiet cadences of pure finesse are sparse and infrequent; the potency of action that would otherwise be respectable is diluted by this shortage. Nevertheless, fun is found in this flick, which hosts some truly excellent sequences.	positive
Wait for it to be aired on cable.	negative
While the re-enactments may be fascinating as history, they are too crude to serve the work especially well.	negative
Although the ending leaves you unfulfilled, the performances in this memorable ensemble piece are ones to enjoy.	positive
The next big thing's directorial debut is not so big (and not so hot).	negative
Happily along for the ride will kids go in this sparklingly inventive and artful tale, which is always fast and furious, for the first two-thirds.	positive
Barely afloat, this is just another story of a fish out of water.	positive
In the modern era, a fatal mistake that cannot be avoided by Labute is the transformation of the male academic from a lower-class Brit to an American, a choice that disrupts the exquisite balance of the novel and tears apart the fabric of the film.	negative
Each year, an elaborate haunted house is assembled by a Pentecostal church in Dallas, which focuses on scaring teenagers into attending services in a fascinating and often candid documentary.	positive
A movie featuring 11-year-old boys who have sports dreams of their own, along with the preteen girls that idolize lil' bow wow.	positive
As long as Hollywood doesn't produce an original idea for a teen movie, there will continually be these rehashes to serve the younger generations. Eventually, that will occur.	negative
This movie, I can imagine as a b&w British comedy from around 1960, featuring Peter Sellers, Kenneth Williams, and others, yet, with this cast at this time, is hopeless.	negative
Between its powerful moments, it meanders.	negative
Adults, except for the parents, will find it hard to succumb to the call of the wild.	negative
One of his richest roles in years is enjoyed by Andy Garcia, while Mick Jagger delivers his best movie performance since, well, Performance.	positive
Representing not so much a focus on gender, sexual preference, or political agitprop, but rather a triumph of the indomitable human will to rebel, connect, and create, the Cockettes demonstrated such insight and celebratory verve, as shown by Weber and Weissman.	positive
It's not so much enjoyable to watch it; rather, it is enlightening to listen to new perspectives on a past reality and to engage with some individuals who have made an impact in the theater world.	positive
Though it is a great deal of sizzle, very little steak it is. What a spectacular sizzle it is, however! In this incarnation, infectious is the fizz.	positive
In a way that feels very human and very true to life, his soul has been bared by Fisher, and his own shortcomings have been confronted.	positive
A rare, beautiful film.	positive
The most unforgettable moment occurred when medical equipment was thrown at a window by Green; it wasn't particularly amusing, but I was overcome by a strong urge to take the old lady's walker at the end of my aisle and hurl it at the screen in frustration.	negative
The eventual success of the movie should be credited to Dennis Quaid, who is in fighting trim shape both as an athlete and as an actor.	positive
In the middle somewhere, the film compels; while he experiments, Demme harvests a few gems of movie moments, yet the field of roughage dominates.	negative
With a tawdry b-movie scum, it is glazed.	negative
O fracasso 'artístico' de doce lar é diretamente responsabilidade do roteirista c. jay cox, que sequer consegue aproveitar os pouquíssimos momentos em que escapa da mediocridade.	negative
Standing in the shadows of Motown, the cultural history of the best kind is informative, revealing, and richly entertaining, serving as a belated nod to some neglected all-stars.	positive
a cinematic portrait that is vivid.	positive
An adequate reason why we should pay money for what we can get on television for free is never provided by Irwin and his director.	negative
The belief of some studios is firm in that people have supposedly lost the ability to think, and any shoddy product will be forgiven as long as there’s a little girl-on-girl action.	negative
Irrelevant is whether you buy the stuff about Barris being a CIA hit man; impressive, inventive, and daring is the kooky yet shadowy vision that Clooney sustains throughout.	positive
By cedar, impressive control is demonstrated both in the writing and visually, taking a very open-minded approach to this sensitive material.	positive
Wrapped up in recycled paper with a shiny new bow is a classic struggle between mother and daughter, and although the audience can tell that it's not all new, at least it looks pretty.	negative
The talents of screenwriter Charlie Kaufman, creator of Adaptation and Being John Malkovich, are reinforced.	positive
An approximation of better films like contempt and 8 1/2 that is mimetic.	negative
With a steady hand, Howard presents an account of the near-disaster that remains solid, though somewhat heavy-handed, if not very imaginative.	positive
Sour, not so much farcical.	negative
A vivid, vibrant individual is ana, and the movie's success and accessibility stem from its focus on her.	positive
Being buried in a new environment, it is an experience so engrossing.	positive
Provocative and boldly energetic.	positive
A big, gorgeous, mind-blowing, breath-taking mess is what the film is.	positive
In the text are present its charming quirks and dull spots.	negative
A severe case of oversimplification, superficiality, and silliness afflicts the story.	negative
Soon, the plot grows thin, and you find yourself praying for a quick resolution.	negative
Humor is spiced into the narrative, as denlopp advises, "I speak fluent flatula," following a rather, er, bubbly exchange with an alien deckhand. Witty updatings are incorporated, such as the replacement of silver's parrot with morph, a cute alien creature that mimics everyone and everything around.	positive
Comedy that is acidic and hilarious from Britain.	positive
An international version of a typical American horror film is generic.	negative
While the little ones get a fuzzy treat, sit back, relax, and have a few laughs, as it is definitely not in a hurry, both super-cool and hokey.	positive
A gentle blend consisting of present-day testimonials, surviving footage of Burstein and his family performing, historical archives, and telling stills.	positive
A fascinating, albeit depressing view of Iranian rural life close to the Iraqi border is given by this startling film.	positive
Like a rash, you grow on Adam Sandler's Eight Crazy Nights.	negative
Rather than constructing a laugh riot, we end up with a collection of inconsequential funny moments that are disparate.	negative
A romantic story that is idealistic, bringing out the latent 15-year-old love in everyone.	positive
While a spark or two is thrown off by many of the actors when they first appear, enough heat sadly can't be generated by them in this cold vacuum of a comedy to start a reaction.	negative
More satisfying than almost any recent horror film, it has just enough twists in the tale.	positive
Repellantly out of control, like its title character, is the piano teacher.	negative
Boy, it's a howler, oh boy!	negative
Exuding a chemistry and comfort level that's both saucy and endearing are westfeldt and juergensen.	positive
Very few laughs and even less surprises are contained in . . .	negative
Exploitation is never sunk into.	positive
Set back 30 years is animation, pushed back 40 years are musicals, and at least 50 years is Judaism.	negative
The most irresponsible picture ever released by a major film studio is possibly.	negative
Taking Kurys' career to a whole new level, children of the century, in accomplishment, ambition, and scope, does.	positive
Operating by the rules of its own self-contained universe, a romantic comedy exists.	positive
Here is a British flick that, while gleefully unconcerned with plausibility, is just as determined to entertain you.	positive
The low-key quality and genuine tenderness of wisegirls is what truly surprises.	positive
Like a tasty hors-d'oeuvre are some movies; a feast is this one.	positive
The film's greatest asset lies in how much it distinguishes itself from merely being another connect-the-dots, spy-on-the-run picture.	positive
Either you'll love what you're seeing with the appearance of Treebeard and Gollum's expanded role, or you'll be rolling your eyes. I loved it! Incredible is Gollum's 'performance'!	positive
The director, Steven Shainberg, has succeeded in making his characters quirky individuals rather than figures of fun by focusing intently on them.	positive
As you watch, a film allows you to experience it inside the rhythms of its subject.	positive
A charitable b-minus can be given to the emperor's club, and you don't have to be an especially tough grader to do so.	positive
Exists solely to provide employment for Hollywood kids and those who owe their famous parents.	negative
Hollow, self-indulgent, and - worst of all - boring is dogtown.	negative
A fascinating document of an event that has to be seen to be believed, hell house is often hilarious, well-shot, and, importantly, entertaining.	positive
In Jason X, a lot can be redeemed by its macabre, self-deprecating sense of humor, despite its cheesy effects and hoary plot.	positive
You are missed by us, bluto blutarsky.	negative
Many documentaries similar to this one presuppose the zealous nuttiness or religious bigotry of their antagonists, yet a rare gift for unflinching impartiality is displayed by family fundamentals.	positive
Confused is its message, contorting itself into an idea of expectation, and the last thing any of these three actresses, nor their characters, deserve is the ultimate desire to please.	negative
Is it really as alienating as 'Bartleby' so effectively makes office work?	positive
No question, a comedy has been fashioned by the powers team with more laughs than many, but this time there is some mold on the gold.	positive
This movie's lack of ideas cannot be obscured by any amount of blood and disintegrating vampire cadavers.	negative
Watching Queen of the Damned feels like reading a research paper, with special effects mixed in.	negative
A breezy, diverting, conventional, and well-acted tale features two men locked in an ongoing game of cat-and-cat.	positive
Although a few pieces buzz and whir, very little of the film actually clicks; the thing just never gets off the ground.	negative
When you are asked to feel sorry for Mick Jagger's sex life by a movie, it already has one strike against it.	negative
An ambiguous icon in Chinese society is how the bike still remains, in a startling and fresh examination.	positive
Among cinema's finest moments this year are those found in this account of the life of artist Frida Kahlo. Unfortunately, the most impossibly dry account of Kahlo's life imaginable sandwiches them in between.	positive
References to faith and rainbows that are throwaway enough exist to plant smile-button faces on that segment of the populace which made a walk to remember a niche hit.	negative
A generation defines its music just as much as the music defines a generation, it understands.	positive
Beginning with a low-budget film that showcases inexperienced children as the main characters might not be the most effective way to gain experience in the film industry.	negative
On the film radar, a minuscule little bleep exists, but it is one that many more people should check out.	positive
Stunning as Frida, a star is made by hayek and . . . a project that.	positive
In the theater, when Seagal appeared wearing an orange prison jumpsuit, I felt like standing up and shouting, 'Hey, Kool-Aid!'	negative
What makes the movie a comedy is how it avoids the more serious emotions involved.	positive
It feels less like being stuck in a dark pit having a nightmare about bad cinema and more like such an incomprehensible mess that it resembles bad cinema.	negative
A nice departure from standard moviegoing fare, it is for those with whom it will connect, but not everyone will find it so.	positive
Although she delivers a game performance, bisset is unable to save the movie.	negative
As a retooling of Fahrenheit 451, as a rip-off of The Matrix, and even as a dystopian movie, it fails.	negative
Filled with plenty of slapstick humor for kids, numerous in-jokes for adults, and enough heart for everyone, this digitally animated feature film is cute, funny, and heartwarming.	positive
So terrific at conveying their young angst are the actors, that we do indeed feel for them.	positive
Well paced, touching, and witty.	positive
In swimming, the story is told with patience, unlike most teen flicks, featuring mostly little-known performers in key roles and introducing some intriguing ambiguity.	positive
A poignant and powerful narrative reveals in life that reading, writing, and arithmetic are not the only subjects to learn.	positive
Repulsive and depressing is the cumulative effect of the movie.	negative
job hack brisk.	negative
A hit-or-miss aesthetic that often hits is used by [anderson], keeping the film entertaining, even if none of it makes a lick of sense.	positive
Whether it wants to be a gangster flick or an art film, the empire can't decide. As either, it doesn't work.	negative
With a gun, Charlize is chasing Kevin. Stuart is being chased by Courtney with a cell phone. The ringing of cell phones and the sound of gunfire.	negative
Disturbing and brilliant documentary.	positive
The two leads with their acting chomp considerably more scenery than is barbecued by fire-breathing monsters with their breath . . .	positive
about dragons draggin'	negative
From the train, throw smoochy!	negative
While I admit to having walked out of Runteldat, I did go back to witness the final 10 minutes; nevertheless, those minutes proved to be even more repulsive than the initial 30 or 40 minutes.	negative
Like shooting fish in a barrel, the war of the roses is trailer-trash style, entertaining but.	negative
A half-wit remake of the venerable Italian comedy Big Deal on Madonna Street is enjoyably present.	positive
Swill calculated.	negative
Well worth the time is what those with an interest in new or singular sorts of film experiences will find when it comes to "What time is it there?"	positive
Very smart, it is just not.	negative
Almost solely as an exercise in gorgeous visuals commands interest from minority report, cold and scattered. Minimally satisfying, that is not vintage spielberg and that, finally.	negative
A complete shambles, this movie is so unpleasant, so uneven, and so sloppy that I can't believe any viewer, young or old, would have a good time here.	negative
Emotionally scattered, a hero in a well-made film gives his heart solely to the dog.	negative
Direct-to-void is where a release is heading, nowhere.	negative
Just another major league, it is, despite its attempts to be much more.	negative
Often moving, the piece explores the discomfort inherent in the contacts between the 'hosts' and their 'guests.'	positive
Somehow, a film that would typically be relegated to a dark corner of a video store is making its way to theaters. It is hard to imagine any acting that could be flatter.	negative
Contemplative and mournfully reflective is Noyce's film.	positive
During the 90 minutes of screen time for the tuxedo, a single genuine 'chan moment' does not occur.	negative
An engrossing, psychologically resonant suspenser that is mostly intelligent.	positive
Lasting at least 90 more minutes, it is very similar in content to one of [spears'] music videos, and even worse, you must pay if you wish to see it.	negative
Teaching kids about the dangers of drugs effectively, I believe, can be achieved through projects like the (unfortunately r-rated) paid, if there is a way.	positive
In the thin soup of canned humor, the moments of creative insanity that are isolated finally become lost.	negative
Surrounding its ludicrous and contrived plot, the château is never quite able to overcome the cultural moat.	negative
A unique insight into a culture that many of us are unfamiliar with is provided by an authentic film featuring genuine individuals.	positive
An honestly nice little film, "take care of my cat," takes us on an examination of young adult life in urban South Korea through the hearts and minds of the five principals.	positive
Thankfully, the role is outshone by farrell, and he successfully plays the foil to willis's world-weary colonel.	positive
. . . pretension of hokey art house.	negative
While the results are honest and the effort sincere, the film is so bleak that it’s hardly watchable.	negative
a masterpiece modest.	positive
Better-than-average movie-making is represented by it, which doesn't demand a dumb, distracted audience.	positive
In an honest and gentle way, there are moments when it can be heart-rending and unaffected.	positive
Stretched out to 90 minutes was a little half-hour, static and sugary after-school special about interfaith understanding.	negative
Something quite fresh and delightful is the result.	positive
Essentially devoid of interesting characters or even a halfway intriguing plot is Ash Wednesday, unlike Scorsese's Mean Streets.	negative
Garbage is just this thing.	negative
A seaworthy chiller that is solidly.	positive
The clever plot contrivances and smart wordplay of Sayles are as sharp as ever, though some strong performances may overshadow them.	positive
No sympathies for any of the characters were elicited by the full frontal, and it had no effect. By that measure, a failure it is.	negative
Terrible, truly.	negative
Plenty to ponder and chew on is offered by the unusual relationship as it slowly unfolds, not being as thrilling or as romantic as it ought to be.	positive
Although the atmosphere is intriguing, the drama is ultimately too predictable to leave a significant impression.	negative
At no moment in the enterprise did I desire to not lie down in a dark room with something cool against my brow.	negative
A kingdom that, strangely, comes off as more mild than wild.	negative
Director Chris Columbus takes a hat-in-hand approach to Rowling once again, leading to a stifling of creativity and causing the film to drag on for nearly three hours.	negative
Plodding, peevish, and gimmicky.	negative
A movie that may come across as a bit too smugly superior to appreciate, while being too smart to overlook, could end up slapping its target audience in the face by shooting itself in the foot.	negative
An exquisitely polished and upholstered machine, slick and well-oiled.	positive
Footage that could have transformed a frustrating misfire into a trenchant, ironic cultural satire lies somewhere on a cutting room floor.	negative
A hal hartley wannabe film is what it puts on airs of -- lacking, however, the vital comic ingredient provided by the hilarious writer-director himself.	negative
Although it is beautifully filmed and well acted, its narrative specifics are, admittedly, problematic.	negative
So steeped in the majesty of Tolkien's writing are director Peter Jackson and his crew that new joys are produced in every frame, whether you're a fan of the books or not.	positive
While mama takes a bit too long to find its rhythm, and somewhat melodramatic is the third-act plot development, sure to be pleased by its ribald humor and touching nostalgia is anyone in search of a jules and jim for the new millennium.	positive
Still not quite knowing how to fill a frame is Mendes; like the Hanks character, a slow study he is: stilted is the action and embalmed the tabloid energy.	negative
Present to observe time during that second round were the subtleties of Ramsay's portrait of grief.	positive
Oh my, is this an invigorating, electric movie?	positive
More ingeniously constructed than "memento" is a screenplay.	positive
To be chiefly influenced by humanity's greatest shame — reality shows, for god's sake! — should be punishable by chainsaw, a crime.	negative
A delicate balance of romantic innocence and philosophical depth is achieved by Tuck Everlasting.	positive
Set to become the 21st century's new "Conan," the rock is going to create an even bigger impact than Arnold Schwarzenegger, Jean-Claude Van Damme, or Steven Seagal.	positive
This unusual comedy is kept from choking on its own conceit, especially by the inimitable Walken and Tierney in the AM-radio soundtrack and game cast.	positive
Everything that happens may not be understood by children -- even Miyazaki himself is not sure -- but they will almost certainly be fascinated, and undoubtedly delighted.	positive
An experience that is exhilarating.	positive
Embracing the time-honored truth that love is the most powerful thing in life, a film that is lighthearted and feel-good.	positive
So distasteful is the element of condescension, as their lofty perch allows the filmmakers to look down on their working-class subjects, that sex with strangers, which opens today in the New York metropolitan area, becomes.	negative
Despite having all the right elements, it completely fails to come together.	negative
This cloying story is hell, a tale of voices from the other side.	negative
While its predecessor is a classic, this version may not be, yet plentiful are its pleasures still.	positive
A blandly cinematic surgical examination of what makes a joke a joke is merely what it is intended to be -- it won't bust your gut, and that's not its intention.	positive
Awful and inane, this wannabe comedy is wretchedly unfunny—no doubt about it, it's the worst movie I’ve seen this summer.	negative
Attempts to address serious issues regarding Iran's electoral process are made by Payami, yet the outcome is a film that is as subtle as a party political broadcast.	negative
Lulling you into a gentle waking coma at times, it is loud and offensive, yet more frequently.	negative
After witnessing numerous Greek-American weddings and, thankfully, not being a victim of any, I can attest to the relative accuracy of Ms. Vardalos' memories and insights.	positive
Sinking to a Harrison Ford low, K-19 does so with or without ballast tanks.	negative
With a hefty helping of re-fried green tomatoes, the not-so-divine secrets of the ya-ya sisterhood are intertwined.	negative
Although much effort and intelligence is on display, in execution it comes off as awkward, static, and lifeless rumblings.	negative
A film that is both comprehensive and provocative -- it pushes the boundaries of biography and challenges its audience.	positive
Since Shinya Tsukamoto's Iron Man, I don't think an Asian film has entranced and appalled me as much.	positive
Thankfully understated are Goyer's screenplay and direction, and excellent performances from his cast have been drawn by him.	positive
Reign of Fire, while it may just be another platter of reheated aliens, is still quite tasty.	positive
What remains, after removing the controversy, is not much more watchable than a Mexican soap opera.	negative
Ironically, the story has little to do with sex, which ultimately revolves around how lame it is to evade your responsibilities, and it emphasizes that you should never, ever, leave a large dog alone with a toddler. But aside from all that; the boobs are fantastic.	negative
A road-trip version of Mama's Family that is R-rated and feature-length.	negative
Boredom drowned me in the pool.	negative
For its fine acting and soccer action, the movie exists.	positive
A drama that is part homage and part remake of the Italian masterpiece, intriguing but uneven.	positive
Better than a hollow tribute is what the code talkers deserved.	negative
Displaying his cadness to perfection, Grant also showcases an acting range that may surprise some who believed that light-hearted comedy was his forte.	positive
A tale that is both charming and poignant about the irrevocable ties that bind.	positive
Through surrealist flourishes so overwrought that you'd swear he just stepped out of a Buñuel retrospective, the past is conjured by Howard.	negative
Only those who appreciate film violence in all its forms will find anything here to enjoy, and they will be most addicted.	negative
Constantly, the same ideas being repeated in films is something I complain about, yet the Bourne Identity shows that a fresh take is always possible.	positive
Off is everything.	negative
Nothing but love is held by stephen earnhart's homespun documentary mule skinner blues for its posse of trailer park denizens.	positive
Thanks to its hallucinatory production design, the movie stays afloat.	positive
Catsup is as plain and pedestrian as--	negative
The heat that ignites this gripping tale can be felt, along with the humor and humanity that ground it in feeling.	positive
This stuff is cool and slick, ready to quench the thirst of an audience that misses the summer blockbusters.	positive
Slight but unendurable, how to kill your neighbor's dog, written and directed by Michael Kalesniko, is as crimes go.	negative
The master of disguise is funny—not "ha ha" funny, but "dead circus performer" funny. For all the wrong reasons, besides.	negative
Although it is painful to watch, those viewers who are willing to take a chance will find themselves rewarded with two of the year's most accomplished and riveting film performances.	positive
Noyce films it more as a shocking history lesson than as a drama.	positive
When it should focus primarily on the killer's mind, the film Dahmer resorts to the typical thrills of a slasher flick, thus missing a significant chance to provide a truly revelatory insight into his psyche.	negative
Undeniable are the physically spectacular qualities of the film, as is the emotional integrity of the performances.	positive
Trailer park Magnolia: too long, too cutesy, too sure of its own importance, and possessing that peculiar tension of being about too dense & nothing at all.	negative
Coming off as a flat and unconvincing drama that never catches fire, it is more like a misdemeanor.	negative
A film that is intelligent, moving, and invigorating.	positive
It is too silly and sophomoric to ensnare its target audience.	negative
Almost as much as her work with Haynes in 1995's Safe, Moore's performance impresses.	positive
About its characterization of Hitler and the contrived nature of its provocative conclusion, we wonder less regarding its ideas.	negative
The idea of making Kahlo's art a living, breathing part of the movie is utilized by [Taymor], often catapulting the artist into her own work. This isn't a new idea; it has been done before, but never so vividly or with so much passion.	positive
Rocks, Spiderman.	positive
Mildly interesting to ponder is the peculiar American style of justice that plays out here, yet so muddled and derivative that few will bother thinking it all through.	negative
Disturbing and absorbing -- perhaps more disturbing than initially intended -- yet greatly beneficial could have been greater clarity.	positive
With its heart, what "empire" lacks in depth is made up for.	positive
How to spin a tale, behan himself knew, and one can't help but think that this attempt to turn his life into art would be appreciated by him.	positive
It is only through an epic documentary that all of it could be captured, and at long last, spike lee's jim brown: all american provides a film that is worthy of the talents of its subject.	positive
Like a cheap lawn chair, the script falls apart and becomes lifeless.	negative
Between surf shots, most of the storylines feel like time fillers. While the movie isn't horrible, you can see mediocre cresting on the next wave.	negative
Every potential twist is telegraphed well in advance; every performance is respectably muted, and it appears that the movie itself has been made under the influence of rohypnol.	negative
Predictable plotting and tiresome histrionics push into the margins what little grace is achieved by [rifkin's] tale of precarious skid-row dignity.	negative
Despite its noticeable lack of emotional heft, this work stands as an example of sophisticated and challenging filmmaking, contrasting with the indulgent dead-end experimentation of the director's previous full frontal.	positive
Throughout the film, as Harris physically and emotionally disintegrates, his exaggerated performance carries a certain poignancy considering his recent death; however, Boyd's film offers little else of significance.	negative
A marvelous, merry, and, yes, melancholy film.	positive
Trimmed by about 20 minutes now, this three-year-old production boasts enough grandeur and scale to satisfy as grown-up escapism in a lavish manner.	positive
From the sixth sense to the mothman prophecies, every ghost trick is trotted out by shadyac, who deserves to be among the damned for perpetrating patch adams.	negative
This film, filled with detail and nuance, speaks volumes about the ability of the human spirit to find solace in events that could easily crush it forever.	positive
The sort of delicate, articulate character- and- relationship study that Rohmer has favored for decades from Elliott's memoir is Fashioned.	positive
Watching blobby old-school CGI animation in this superlarge format is just surreal enough to be diverting of an experience.	positive
After you leave Justine, long will it be until you wonder what will happen to her and wish her the best -- whatever that might mean.	positive
For almost an hour and a half, you will laugh, but strangely you’ll come out feeling unsatisfied. You’ll feel like you ate a Reese’s without the peanut butter…	negative
In snow dogs, a black man is humiliated by a pack of dogs that are smarter than he is, which is where the humour is found.	negative
Not more than recycled jock piffle, but pleasant.	negative
Not hateful, it is. Simply stupid, irrelevant, and deeply, truly, bottomlessly cynical, it is.	negative
This is one of the oddest and most inexplicable sequels in movie history.	negative
An arousing good time is made by [sex and lucía], a randy film about sexy people being pushed and pulled (literally and figuratively) by desire in gorgeous places.	positive
Of the year, the film is the worst.	negative
Despite the legendary actor Michel Serrault and the scenic splendor of the mountains being showcased in the film, it is less successful on other levels.	negative
A bad movie is what it is, not a bad premise.	negative
Attributing my good time with this movie to my adoration for both De Niro and Murphy can be done despite its myriad flaws.	positive
The prospect of the human race splitting in two likely would make Welles unhappy, and he probably wouldn't be too pleased with the movie of his great-grandson splitting up in pretty much the same way.	negative
a comedy/thriller that is imaginative.	positive
The remarkable feat of squandering a topnotch foursome of actors is achieved by Brady . . . by shoving them into every clichéd white-trash situation imaginable.	negative
It is a confirmation, depressing in nature, of everything we who don’t object to the description “unelected” have suspected all along: that an incurious, uncharismatic, overgrown frat boy with a mean streak a mile wide is George W. Bush.	positive
Formulaic, more like to the 51st power.	negative
A salute to the universal language of rhythm, it is a brave attempt to tap into the heartbeat of the world and a zippy sampling of sounds.	positive
While it may be impeccably filmed and sexually charged, it ultimately lacks substance and is dragged down by a leaden closing act.	negative
Sufficient science exists to qualify it as educational, and sufficient beauty exists to render it unforgettable.	positive
Worn down by the boys' sparring, like the succession of blows dumped on guei, are the story's more cerebral and likable plot elements.	negative
Commended should be Parker for taking a fresh approach to familiar material, but a somewhat mannered tone is adopted by him in his determination to remain true to the original text . . . that ultimately dulls the human tragedy at the story's core.	negative
More depressing than entertaining is sam's self-flagellation.	negative
While it may not be "last tango in Paris," it is...	positive
This motion picture is viewed as a comedy, a romance, a fairy tale, or a drama, yet there's nothing remotely triumphant about it.	negative
Awful, thoroughly.	negative
It’s too shallow for an older crowd; it’s too slow for a younger one.	negative
At about 95 minutes, a brisk pace is maintained by Treasure Planet as it races through the familiar story. However, the epic quality and grandeur often associated with Stevenson’s tale, as well as earlier Disney efforts, are lacking.	positive
Not only does a fascinating connection exist to the Serbs themselves, but also to a network of American right-wing extremists in this horrid little propaganda film.	negative
Encountering a story unlike any other you are likely to see anywhere else, along with a flick that will sock you in the eye and is a visual tour-de-force, is possible if the harsh realities and fantastical aspects of "the isle" can be looked beyond.	positive
The fact that a walk to remember is shrewd enough to activate girlish tear ducts doesn't imply that it is good enough for our girls.	negative
An uninspired philosophical epiphany is wending its way through laggard drama.	negative
A black comedy that is bitter and deliciously mordant.	positive
Never does Kurys explain why Sand and Musset, among the volatile romantic lives of the period, deserve particular attention.	negative
Involving us because of its incisive nature and bleakly amusing take on how we navigate our lives, lovely & amazing features a cast that includes some of the top actors working in independent film.	positive
One of the least inspired works by [herzog].	positive
A plot that crawls along at a snail's pace and dialogue that is cheap and vulgar.	negative
If taken in large doses, this is likely to cause massive cardiac arrest as saccharine movies go.	negative
In the grand scheme of things, more in love with strangeness than excellence is road to perdition.	negative
From childhood idealism to adolescent self-absorption, a marvellous journey unfolds.	positive
An understanding of great comedy by a filmmaker is that it doesn’t always need to make us laugh. However, Tim Story has not yet reached that point; nonetheless, 'Barbershop' shows that he is on the right path.	positive
If possible, imagine a pasolini film devoid of passion or politics, or consider an almodovar movie lacking beauty or humor, and you will have some sense of the glum, numb experience that is watching o fantasma.	negative
The academy loves this type of stunt: an otherwise mediocre film stuffed with a powerful political message.	negative
Despite having an achingly enthralling premise, the film is hindered by lapses in plot and uneven dialogue.	negative
It is inspirational to characterize how the same human and spiritual needs are shared by people from such diverse cultures.	positive
Purchase the Philip Glass soundtrack CD and skip the film.	negative
At accelerated speed and volume, ernest hemmingway's method is steve irwin.	positive
Skilled ensemble actors hold together a movie that is pleasant enough.	positive
A showcase that is awkwardly garish and diverges from anything remotely probing or penetrating.	negative
The guy is gotten by the girl, the guy is lost by the girl, the audience falls asleep.	negative
Worth seeing is something that there is everywhere the camera looks.	positive
Even in his most forceful non-Shakespeare screen performance, the angry revolt of his wit grounds even the softest moments by Branagh.	positive
On a truly grand scale, a rousing good story presents an irresistible combination.	positive
Rather than being a movie, it serves more as a joint promotion for the national basketball association alongside teenaged rap and adolescent poster-boy lil' bow wow.	negative
Sketchy is Breen's script, with actorish notations on the margin of acting.	negative
It appears that the sting is absent in any of this so-called satire, as if Woody fears to bite the hand that has finally warmed up to him.	negative
Flirting with one another is engaged in by the characters as the mystery unravels.	negative
A date movie you wouldn't call the good girl (more like an anti-date movie), but when it is good, horrid it is and good.	positive
From a master filmmaker comes a masterful film, unique in its grimness that is deceptive, compelling with its fatalist worldview.	positive
Like a cheap lawn chair, the script falls apart and becomes lifeless.	negative
Even though it is not a great Bond movie, it is still a good one, making it much better than the typical Bond knock-offs.	positive
The many inconsistencies in Janice's behavior can't quite be negotiated by Walsh, nor can they be compensated for by sheer force of charm.	negative
So good as Leon Barlow is Howard . . . that hardly does he seem to be acting.	positive
The expectations were well below.	negative
Uniformly excellent and relaxed is the cast.	positive
So dependent on being 'naturalistic' rather than carefully lit and set up, the video work is exhausting to watch, as it is so grainy and rough.	negative
Es un buen ejemplo de cine de entretenimiento puro y sin complejos, más sarcástica, divertida y demencial que su predecesora.	positive
Poo cinematic.	negative
Harvard Man, being ludicrous enough, is unintelligible, poorly acted, and brain-slappingly bad that it could become a cult classic.	negative
Confusing its message is an ultimate desire to please, and contorting itself into an idea of expectation is the last thing that any of these three actresses or their characters deserve.	negative
With a persona given by Huppert that is so intriguing, you find yourself staring at Erika hypnotically, trying to understand her and wondering if she'll crack.	positive
To be believed, it must be seen.	positive
Sometimes, the bad choices that mothers and fathers make in the interest of doing their children good evoke the fear that parents have for the possible futures of their children.	positive
A strong case for the importance of the musicians in creating the Motown sound is made by the film.	positive
Certain movies, at times, have very, very good reasons for being sealed in a jar and left on a remote shelf indefinitely.	negative
This film, while not surprising in the least, is ultimately very satisfying. Think of it as a kind of comfort food for the mind.	positive
In the modern era, a fatal mistake cannot be avoided by Labute: the male academic has been changed by him from a lower-class Brit to an American, a choice that upsets the exquisite balance of the novel and shreds the fabric of the film.	negative
Merely serving as a blandly cinematic surgical examination of what constitutes a joke, it is not intended to bust your gut.	positive
You will be shocked if what you expect is a light romantic comedy, but it is a good movie and a good actress.	positive
Presenting Schwarzenegger as a tragic figure, collateral damage evokes a sense of sympathy that truly belongs to any viewer subjected to the excruciating end of days, forced to watch him attempt so many complicated facial expressions.	negative
Touching, witty, and well paced.	positive
A fascinating documentary and a necessary political work, it is . . .	positive
Raunchy and graphic in presentation as it may be, almost nothing else is one-sided, outwardly sexist, or mean-spirited; and in a sense, that's a liability.	negative
Although a spark or two is thrown off by many of the actors when they first appear, in this cold vacuum of a comedy, a reaction cannot be started, as enough heat cannot be generated by them.	negative
Now trimmed by about 20 minutes and three years old, this lavish production has enough grandeur and scale to satisfy as grown-up escapism.	positive
Starting off with a bang, though, it ultimately fizzles at the very end like a wet stick of dynamite. Still, it’s worth a look.	positive
We are always engaged by it.	positive
These days, Woody Allen has truly found his groove, but the issue lies in the fact that it enables him to produce one mediocre movie after another.	negative
Serving reasonably well as a star vehicle for Zhao, it is consistently odd and occasionally funny.	positive
Early on, as it plays the culture clashes between the brothers, it is at its best.	positive
More of a picture book for the big screen than a movie; although this might not be my favorite in the series, I found enough enjoyment to recommend it.	positive
A variation that is derivative, unimaginative, and tired of that already-shallow genre.	negative
Expectations are exceeded by "extreme ops." Good fun, good action, good acting, good dialogue, good pace, good cinematography.	positive
An exciting action-filled sports movie takes place on the field, alongside a story that you care about off of it.	positive
Realizing that we have a long way to go before fully understanding all the sexual permutations involved, one is struck by the film's ending.	positive
Life inside a one-room schoolhouse in northern France is observed by Nicolas Philibert in his documentary "To Be and to Have," which makes it easily one of the best films of the year.	positive
Even though there's no plot in this Antonio Banderas-Lucy Liu faceoff, I don't care; it's still terrible!	negative
Here, a good job is done by Bullock of working against her natural likability.	positive
Glitzy and formulaic, yet silly . . . Cagney's 'top of the world' has been replaced by the bottom of the barrel.	negative
It feels as though you've endured a long workout without ever having your pulse race, leaving.	negative
Whether or not you believe the claims about Barris being a CIA hitman, the kooky yet shadowy vision that Clooney maintains throughout is daring, inventive, and impressive.	positive
So excellent are the drumming and marching in this high-energy movie that who cares if the story's a little weak.	positive
Despite their historical fascination, the re-enactments are too crude to serve the work especially well.	negative
A playful and enthralling film that constantly frustrates our desire to know the 'truth' about this man, while in a manner that Derrida would doubtless bless, deconstructs the very format of the biography.	positive
As soon as macho action conventions assert themselves, the movie slides downhill.	negative
An ungainly movie this is, with its elbows sticking out where the knees should be, ill-fitting.	negative
Similar to the content of one of [spears'] music videos, it is quite a bit -- the difference being that it goes on for at least 90 more minutes and, even worse, you must pay if you want to watch it.	negative
The Bourne Identity is what summer screen escapism used to be in the decades when it was more geared to grownups.	positive
It's not that all of it is derivative, as many funny movies recycle a lot of old tropes; rather, the problem lies in the fact that Van Wilder does little that is actually funny with the material.	negative
Nearly incoherent is Undisputed, serving as an excuse to reach the closing bout, while the absence of narrative continuity is covered by flashbulb editing... at which point about who wins it's impossible to care.	negative
In the end, an honorable, interesting failure is possession. While it falls far short of poetry, prose that is not bad it remains.	negative
It comes off as so silly that you wouldn't be surprised if a black and red van were seen giving chase by Murdock, BA, and the rest of the A-Team.	negative
Even though the nuclear crisis sequences are handled evenly by Bigelow, drama is milked when suspense should be built, and too many scenes toward the end that should move quickly are dragged out.	negative
The effort to watch is worth it.	positive
Something quite fresh and delightful is the result.	positive
Achieving the remarkable feat of squandering a topnotch foursome of actors is done by Brady . . . by shoving them into every clichéd white-trash situation imaginable.	negative
To entertain, tailored is !	positive
Beyond her abilities, MacDowell ventures several times and reveals how poor an actress she is.	negative
Insomnia is what is involved. I thought it could still have been more.	positive
Packed with fleet turns of plot and a feast of visual amazement, resonant, dark, and inventively detailed is the text.	positive
This romantic comedy, warm and gentle, is filled with enough interesting characters to populate several movies, possessing ample charms that should even win over the most hard-hearted cynics.	positive
The beating heart of director Denis Villeneuve can still be felt beneath the gloss, along with the fondness he has for his characters.	positive
A delightfully quirky movie can be made from curling, but it isn't brooms.	negative
Despite the good will generated by the actors, eventually showtime collapses under its own thinness.	negative
Too bad that eventually the screenwriters end up shooting themselves in the feet with clichés like an oily arms dealer, squad car pile-ups, and the requisite screaming captain, it is.	negative
With great cinematic innovation, the heaving passion of Puccini's famous love-jealousy-murder-suicide fandango is conveyed by director Benoît Jacquot, making his first opera-to-film translation with Tosca.	positive
Despite possessing energy, Davis does not succeed in making her heroine's book sound convincing, the gender-war ideas original, or the comic scenes effective.	negative
With the ferocity of a frozen burrito after an all-night tequila bender, our culture is headed down the toilet, and this I know because I have seen 'Jackass: The Movie.'	negative
The outstanding feature debut of writer-director Eric Byler marks a work of the utmost subtlety and perception, understanding the power of the implicit and the virtues of simplicity and economy.	positive
A film of the nervous kind that will either exhilarate you or give you a mild headache.	positive
With his cast of non-actors and a gritty, no-budget approach, a cruelly hilarious vein of black comedy is managed to be captured by Novak in the situation.	positive
It is not much more watchable than a Mexican soap opera without the controversy.	negative
While the movie serves as a revenge thriller, it lacks the delicious guilty pleasure that the superior film versions offer.	positive
Off is everything.	negative
It's not clear at all what it's trying to say, and I doubt that even if it were, it would be all that interesting.	negative
Such a dazzlingly self-assured directorial debut, it is hard to know what to praise first.	positive
Less about its ideas and more about the characterization of Hitler and the contrived nature of its provocative conclusion, we are left wondering.	negative
Observing a movie is what you do rather than entering into it.	negative
A daring work of genius, the piano teacher is subversive, meditative, clinical, and poetic.	positive
Directed by Alan Taylor, and adapted by Kevin Molony from Simon Leys' novel "The Death of Napoleon," while Napoleon's journey is interesting, stillborn is his rebirth in Paris.	positive
Martial arts and gunplay that are mindless and boring, lacking excitement and a compelling storyline.	negative
All the time, I complain about the same ideas being repeated in films over and over again; however, the Bourne Identity demonstrates that a fresh take is always possible.	positive
I believe that, when it comes to Alzheimer's disease, there is more honesty than with Iris.	positive
Like a flimsy excuse for giving blade fans another look at wesley snipes' iconic hero doing battle with dozens of bad guys at once, the sequel plays out.	negative
Neither bitter nor sweet, neither romantic nor comedic, neither warm nor fuzzy is a film.	negative
Through surrealist flourishes so overwrought that you'd swear he just stepped out of a retrospective by Buñuel, the past is conjured by Howard.	negative
Watching blobby old-school CGI animation in this super-large format is just surreal enough to be diverting, the experience of.	positive
The element of condescension, then, is distasteful, as the filmmakers look down upon their working-class subjects from their lofty perch, which makes sex with strangers, opening today in the New York metropolitan area, so.	negative
Confusion is one of my least favourite emotions, especially when I have to endure it for 146 minutes.	negative
Though it surpasses a mid-range Steven Seagal, the sharpness of Jet Li on rollerblades is lacking in it.	negative
A misfire that is peculiar cannot even be saved by Tunney.	negative
Weird feelings arise in me / when I think about all the bad things in the world / such as broken-legged puppies / and dying butterflies / and movies featuring pop queens.	negative
In Haynes's work, everything is just about right, including the perfectly melodic score by Elmer Bernstein and the big giant titles of the opening credits.	positive
The year's most thought-provoking film, without a doubt, it pays a price for its intricate intellectual gamesmanship.	positive
A loving screen transferral has been given to the memoir, Borstal Boy, by legendary Irish writer Brendan Behan.	positive
Windtalkers blow this way and that, but in the tall grass, the filmmaker is there, true to himself, with no mistaking.	positive
Most audiences will almost certainly be bored into their own brightly colored dreams by an experiment that is bold (and lovely).	negative
Spoofing an easy target, those old '50s giant creature features may be, but it acknowledges and celebrates their cheesiness as the reason why people get a kick out of watching them today.	positive
Set against the strange, stark beauty of the Mideast desert, the passions aroused by the discord between old and new cultures are so lovingly and perceptively filmed that you can almost taste the desiccated air.	positive
A true story concerning real individuals who are living their lives, worried about the future of a family member who is elderly and mentally handicapped.	positive
Quirky characters, odd situations, and off-kilter dialogue are presented to us, all seemingly proclaiming, "Look at this! This is an interesting movie!" Ultimately, however, the film is quite unengaging.	negative
Drivel that is animated, meant to enhance the self-image of drooling idiots.	negative
At approximately 95 minutes, Treasure Planet maintains a brisk pace through the familiar story; however, the grandeur and epic quality often associated with Stevenson's tale, as well as earlier Disney efforts, are lacking.	positive
His audience serves as a figurative port-of-call, where dong unloads his even-handed ideological ship before continuing on his longer journey still ahead.	positive
Surely, this gutsy and at times exhilarating movie would have been called a great yarn by Fuller.	positive
Commended is Parker's determination to remain true to the original text as he takes a fresh approach to familiar material; however, this leads him to adopt a somewhat mannered tone... a tone that, ultimately, dulls the human tragedy at the core of the story.	negative
While Waydowntown is by no means a perfect film, it boasts a huge charm factor and smacks of originality.	positive
Targeted to the tiniest segment of an already obscure demographic is an incredibly narrow in-joke.	negative
Watching they offers nothing to gain. It isn't scary. Its characters are hated by it. No way is found by it to entertain or inspire its viewers.	negative
Everyone is to blame here.	negative
A great premise was the start of one of those films, but then it just fell apart.	negative
The scientific is favored by the film, rather than the spectacular (visually speaking).	negative
At times, one could say that it’s slow; one could also say that a few of the characters behave in ways that real people wouldn’t, but it couldn’t be said that Alias Betty is predictable.	positive
Through the sort of idiosyncratic terrain that Errol Morris has often dealt with, a pleasant ramble exists . . . possessing a loose, lackadaisical charm, it does.	positive
An audience that enjoys the Friday series must exist, but I would not be interested in personally knowing any of them.	negative
Some great insight into the neurotic mindset of all comics is provided by the film -- even those who have reached the absolute top of the game.	positive
This is one of Polanski's best films.	positive
How tedious, how resolutely unamusing, how thoroughly unrewarding all of this is, and what a reckless squandering of four fine acting talents, I can't begin to tell you.	negative
This analysis, which includes a few new swings thrown in, regurgitates and waters down many of the previous film's successes.	negative
Compared to the movie's contrived, lame screenplay and listless direction, nothing is as phony as Britney Spears.	negative
Although the additional storyline is interesting and entertaining, the same magical quality that the beginning of the story possesses is lacking. The old footage still holds my love, and the new material is appreciated.	positive
When viewed independently, better-than-average family entertainment is served by Treasure Planet; however, those who are genuine fans of Stevenson’s novel will likely prefer Disney’s more faithful 1950 live-action swashbuckling classic.	positive
The mystery of enigma is how such a flat, plodding picture could have been yielded by a rich historical subject combined with so much first-rate talent.	negative
You won't want to miss About a Boy if movies like Notting Hill, Four Weddings and a Funeral, Bridget Jones' Diary, or High Fidelity are ones you enjoyed.	positive
Familiar, all its scenes and sensibility are more than, yet it exudes a kind of nostalgic spy-movie charm and is, at the same time, so fresh and free of the usual thriller nonsense that it all seems to be happening for the first time.	positive
No dia em que a direção desta continuação foi aceita por Harold Ramis, ele deve ter saído da cama com o pé esquerdo. E também aqueles que decidiram a assistir a este filme.	negative
Designed to market the charismatic Jackie Chan to even younger audiences, the mechanical action-comedy seems.	negative
Exceedingly hard to forget, it is daring and mesmerizing.	positive
By him, a delicate and articulate character and relationship study is fashioned, drawing from Elliott's memoir, which Rohmer has favored for decades.	positive
As the saga of Star Wars falls into place, the sensation created by the congealing pieces makes your spine tingle with revelation and excitement.	positive
Gimmicky, peevish, and plodding.	negative
The best film of the year so far is this one, and it should serve as the benchmark against which all other contenders for best picture are measured.	positive
On a visceral level that transcends language, bloody sunday connects when it really counts . . .	positive
A crowd-pleaser that is sensitive and expertly acted, which isn't above a little broad comedy and a few unabashedly sentimental tears.	positive
To me, it seems that there are ways to deal with the subject that are more interesting.	negative
Since it is improbable for anyone to visit theatres for this, the design of the project should have been for the tube.	negative
Harsh is an effective documentary on life in the Israeli-occupied Palestinian territories.	positive
More like a serious read, the story feels, filled with heavy doses of always enticing Sayles dialogue.	positive
No Hollywood villain is Evans, an admitted egomaniac, and yet this grating showcase almost makes you wish he'd gone the way of Don Simpson.	negative
Perhaps no picture ever made has shown more literally that good intentions pave the road to hell.	positive
A cruel reminder of the fate of hundreds of thousands of Chinese is served up by this boisterous comedy, which can only qualify as a terrible tragedy.	positive
By the end of no such thing, a sense of watchful affection for the monster is felt by the audience, akin to Beatrice.	positive
As it searches for something fresh to say (I think, vainly), it winds up moving in many directions.	negative
Providing a spell-casting beauty are the laser-projected paintings, while a romantic pairing of hearts, precious and exposed, are Russell and Dreyfus as history corners them.	positive
Love Liza is a festival film that would have been better off staying on the festival circuit.	negative
In search of a better movie experience, a trip to the video store might be inspired, at best, by Cletis Tout.	negative
More attention was received by the story from the merchant.	negative
The existence of the reason why halftime is only fifteen minutes long.	negative
This startling film provides a fascinating, albeit depressing perspective on rural life in Iran near the Iraqi border.	positive
In the telling of a largely untold story, something that is ultimately suspiciously familiar is chosen to be produced by Bui.	negative
A mildly entertaining 77 minutes are made by the weaver's performance as a vaguely discontented woman of substance, its direction, and its script, if that's what you're in the mood for.	positive
A film that seems simple at first glance, one that gains power in retrospect.	positive
As a cinematic milestone, russian ark marks merely a technical, logistical feat.	positive
Fluidly through the story, iconic characters gambol, resulting in charming moments, while the drama of cube's personal revelations regarding the shop's significance in the bigger picture unfolds.	positive
About three years ago, the animation and game phenomenon that peaked is actually experiencing a slow death, if the poor quality of Pokémon 4 Ever serves as any indication.	negative
There are two signs that were sucked up by M. Night Shyamalan's debut feature: Unbreakable and Signs, which all he has to give to the mystic genres of cinema.	negative
Lacking depth or sophistication, the work is exploitative, making such a graphic treatment of the crimes unbearable.	negative
Thanks to some clever writing and sprightly acting, it turns out that a cut above the norm is what it becomes.	positive
This film, rich in detail and nuance, speaks volumes about the ability of the human spirit to find solace in events that could easily crush it forever.	positive
While traditional moviemaking is what it is all the way, there is a lot of careful period attention that is done along with some very welcome wit.	positive
In Stuart Little 2, a refreshing absence of cynicism is present—quite a rarity, even in the family film market. Eventually, you are won over by it.	positive
Enjoying "what time is it there?" is something that the true film buff will find, thanks to the gentle melding of drama and comedy.	positive
A tale of two men locked in an ongoing game of cat-and-cat that is breezy, diverting, conventional, and well-acted.	positive
Going through the motions appears to be what the hill looks like, starting with the pale script.	negative
Chicago is sophisticated, brash, sardonic, and completely joyful in its execution.	positive
Consider the rendition of 'love story' by cleanflicks, where romance novel clichés replace the curses of ali macgraw.	negative
Dull but decent.	negative
Not compelling, but interesting.	negative
Through snow dogs, Cuba Gooding Jr. valiantly mugs his way, yet even this leaden comedy fails to be sparked by his boisterous energy.	negative
During the offbeat musical numbers is the only time that a comedic or satirical target is approached by 8 Crazy Nights.	negative
Running on equal parts of innocence and wisdom, the film features experience-derived wisdom. As it has grown up, fun is had by it.	positive
It is something that [davis] refuses to provide us with, yet an epiphany is what he desires to provoke in his audience concerning real situations and characters.	negative
This sucker deserves more than drowning.	negative
Because it's realistic about all kinds of love, it is genuinely touching.	positive
The whole of storytelling is permeated by fear, in Todd Solondz's oftentimes funny yet ultimately cowardly autocritique.	negative
It is filmed by Noyce more as a shocking history lesson than as a drama.	positive
To be a little different, it dares, and that shading makes it worthwhile.	positive
Like a very goofy museum exhibit, it feels dull and mechanical.	negative
Though mostly indoors takes place the opera itself, unsure seems jacquot of how to evoke any sort of naturalism on the set.	negative
A journey that is compelling . . . and "his best friend remembers" ranks among the finest of specials.	positive
Exuding a chemistry and comfort level that’s both saucy and endearing are westfeldt and juergensen.	positive
A half-wit remake of the venerable Italian comedy Big Deal on Madonna Street is enjoyably done.	positive
This sequel, cuddly and released after the 1999 hit, is visually polished a little more, funnier a little more, and madcap a little more.	positive
A refreshing change from the self-interest and paranoia that shape most American representations of Castro, it is.	positive
Not just another connect-the-dots, spy-on-the-run picture is how much the film's greatest asset is.	positive
A few cute moments can be considered the best thing that can be said of the picture.	negative
Despite our appreciation for Klein's other work, we found Rollerball to be disengaging.	negative
More ingeniously constructed than "Memento" is a screenplay.	positive
Into national media circles, the inchoate but already eldritch Christian right propaganda machine is thrust by the film.	negative
Of intricate elegance, literary lyricism, and profound common sense is a work.	positive
It appears that the sole experience you'll regret, as a reverie about memory and regret, is in remembering the act of sitting through it.	negative
Except for McCoist, the players on the park lack a clue. The acting is not much better either.	negative
Applauded can only be the film for its seriousness, high literary aspirations, and stunning acting.	positive
Only a great premise exists in a film with a great premise.	negative
If a mindset for goofy comedy is what you’re in, the troopers will entertain with their gross outs, bawdy comedy, and head games.	positive
Visible became the subtleties of Ramsay's portrait of grief during that second round.	positive
Stevenson's performance is a volatile combination, being both clueless and fiercely committed at the same time.	positive
Recalled are quiet freak-outs like l'avventura and repulsion.	positive
By amalgamating genres and infusing true human complexity into characters that are not-so-stock, surprising new life is breathed into the familiar.	positive
His noisy, cocky energy is what we need; his passion and class consciousness are needed by us; his shticks are necessary, and his stones are essential.	positive
Typical toback machinations, heavy with flabby rolls, are present.	negative
It resembles a video from a travel agency aimed at those who take pleasure in biking shirtless and wallowing in mud, appearing less like a valuable insight into the guiding lights of independent communities.	negative
The talents of screenwriter Charlie Kaufman, creator of "Adaptation" and "Being John Malkovich," are reinforced.	positive
In brief, human nature does not possess the level of intelligence it believes it has; nor is it as humorous.	negative
Into the world of ambivalence and ambiguity, where few American films dare to delve, Nolan treads bravely.	positive
Seeking out "Ram Dass: Fierce Grace" is worthwhile for anyone interested in one man's response to stroke or who remembers the '60s.	positive
A buoyant, darkly funny dance of death is orchestrated by tok and o together. In demonstrating that there’s still a lot of life in Hong Kong cinema, they engage in this process.	positive
An intelligent fiction about learning arises from a clash of cultures.	positive
Full of twists upon knots, the plot it has . . . and a nonstop parade of mock-tarantino scuzbag types that starts out clever but veers into overkill.	positive
In the long line of films this year about the business of making movies, it ultimately feels like just one more.	negative
To describe exactly how bad it is, new ways of describing badness need to be invented.	negative
Daytime TV serviceability is offered by its plot and animation, but little more.	negative
a portrait of moral emptiness that is compelling	positive
Emotionally scattered, the film is well-made, with the hero giving his heart only to the dog.	negative
Even those viewers who have little patience for euro-film pretension will be impressed by the stunning, dreamlike visuals.	positive
Since Roland Joffé and Demi Moore's adaptation of The Scarlet Letter is the most repugnant of a classic text, it stands out.	negative
A suffocating rape-payback is a horror show that hinges on the subgenre's most enabling victim, coupled with an ebullient affection for industrial-model meat freezers.	negative
The threadbare charms of Sandra Bullock and Hugh Grant have worn, respectively.	negative
Though it may not be everlasting, 77 minutes of Pokémon feels as if it does. My only desire is for Celebi to transport me to a time prior to viewing this movie, so that I could just bypass it.	negative
A drama that is wildly erratic features sequences which make you wince in embarrassment and others that, thanks to the actors, are quite touching.	negative
Early on, it is not difficult to spot the culprit in this predictable thriller.	negative
To ensnare its target audience, it is too silly and sophomoric.	negative
The fact that this is revenge of the nerds revisited -- again, cannot be escaped.	negative
Lost is its sense of humor in a vat of failed jokes, twitchy acting, and general boorishness.	negative
A unique modern fairytale is definitely pumpkin, even though the glass slipper doesn’t quite fit.	positive
A great deal of sizzle exists, yet very little steak. However, it is a spectacular sizzle! In this incarnation, infectious is its fizz.	positive
I never thought I would say this, but to watch fruit pies being poked into by teens with their genitals, I would much prefer!	negative
As an arousing good time, [sex and lucía] is a randy film about sexy people in gorgeous places being pushed and pulled (literally and figuratively) by desire.	positive
Often releasing cinematic flotsam, Disney's live-action division has unearthed a rare gem on this occasion.	positive
Being her own worst enemy, Anna Battista, an Italian superstar and aspiring directress, authors herself as Asia.	positive
While it may not be the most memorable cinema session, the profound self-evaluation message about our fragile existence and the absence of spiritual guidance in Time Changer should at least invade an abundance of mindsets.	positive
This too-long, spoofy update of Shakespeare's Macbeth, while certainly clever in spots, doesn't sustain a high enough level of invention.	negative
Profiled by Smith are five extraordinary American homes, and since the owners seem fully aware of the uses and abuses of fame, a pleasure becomes the enjoyment of their eccentricities.	positive
It may be the most irresponsible picture ever released by a major film studio.	negative
An Iranian drama that is completely awful . . . as much fun as a cold mosque with a grouchy ayatollah.	negative
Enjoyable and conan-esque claptrap, this is more than the punishing, special-effects soul assaults that the mummy pictures represent.	positive
Written so well is "frailty" that even a simple "goddammit!" near the end takes on a whole other meaning.	positive
Drifting aimlessly for 90 minutes, a piece of mildly entertaining, inoffensive fluff finds itself lodged in the cracks of that ever-growing category: unembarrassing but unmemorable.	negative
Since grumpy old men, I have not heard a film that connects so solidly with one demographic while another strikes out, possibly.	negative
A muddle that is pretentious and boring, using a sensational real-life 19th-century crime as a metaphor for -- well, I'm not exactly sure what -- has all the dramatic weight of a raindrop.	negative
Hugh Grant's performance is so consuming that at times, identifying the other actors in the movie becomes difficult.	negative
To stand out, it needs to be more distinctive or even more humorous than it is, but with affection and care, it has clearly been made.	positive
Although the performances in this memorable ensemble piece are enjoyable, one does feel unfulfilled by the ending.	positive
In its quiet, epic way, daring, inventive, and refreshingly unusual, Les Destinées is rich in detail, gorgeously shot, and beautifully acted.	positive
This charming romantic comedy is among the most enjoyable, being by far the lightest dogme film.	positive
Even in this run-of-the-mill vehicle, it's hard not to be seduced by [Witherspoon's] charisma, because this girl knows how to drive it to the max.	positive
Although the editing could be tighter, Hush! sympathetically captures the often futile lifestyle of young people in modern Japan.	positive
Half past dead, a title that is brilliantly named, but wildly incompetent -- or for pessimists of Seagal: totally past his prime.	negative
Very smart it is just not.	negative
With McConaughey in an entirely irony-free zone, and with Bale mainly reduced to batting his sensitive eyelids, there is not enough wit, intelligence, or innovation on the screen to attract and sustain an older crowd.	negative
Is it really as alienating as 'Bartleby' so effectively makes office work?	positive
From films filled with movie references, undeniable enjoyment can be experienced; however, when nothing else is happening, the fun quickly fades and eventually disappears.	negative
A movie that is amazing and incendiary, diving straight into the rough waters of contradiction, is what it is.	positive
In your head, despite its flaws, secretary stays and makes you question your own firmly held positions.	positive
As a classic movie franchise, it is not likely to have decades of life; certainly bond-inspired, let's hope so?	negative
A breath of true sophistication is offered by it.	positive
Cynicism is rhapsodized by reggio and glass, with languorous slo-mo sequences and repetition, making glass's dirgelike score a lullaby that bares its fangs.	negative
When you wake up in the morning, do you say "hi" to your lover?	negative
The moment that stands out the most was when medical equipment was thrown by Green at a window; it wasn’t particularly funny, but I felt a strong urge to grab the walker of the old lady at the end of my aisle and toss it at the screen in frustration.	negative
Fans of Naipaul might feel a sense of disappointment, while those who are unfamiliar with the author's work may quickly find themselves falling asleep.	negative
Closer than anyone could desire to the cheap, graceless, hackneyed sci-fi serials of the '30s and '40s has Lucas come, in fact.	negative
Almost saving the movie is the big ending surprise; it's unfortunate that the rest isn't more compelling.	negative
. . . one’s mind ends up being stuck a lot more by its stupidities than by the cool bits.	negative
The amount of energy needed to describe how terrible this movie is... isn't worth expending.	negative
Almost as much as her work with Haynes in 1995's Safe, Moore's performance impresses.	positive
While there is a lot of good material here, accompanying it is also a lot of redundancy and unsuccessful crudeness.	negative
My adoration for both De Niro and Murphy can be credited for the pretty good time I had with this movie, even though it has myriad flaws.	positive
By offering rousing spates of genuine feeling, it more than compensates for its mawkish posing.	positive
So similar to the 1953 Disney classic seems this follow-up that it makes one long for a geriatric Peter.	negative
A brutal mid-'70s American sports movie is being recycled again, and it's just as useless.	negative
For those who take pleasure in explosions, sadism, and witnessing individuals pummel one another to a pulp, the appeal remains restricted.	negative
A piece that is thoughtful and moving, which faces difficult issues with honesty and beauty.	positive
Since Shinya Tsukamoto's Iron Man, I don't think an Asian film has ever entranced and appalled me as much.	positive
The film itself is about something very interesting and odd, which would probably work better as a real documentary without the insinuation of mediocre acting or a fairly trite narrative.	negative
job hack brisk.	negative
As gritty as a movie gets these days, narc is, aside from a few artsy flourishes.	positive
Into a humorless philosophical void, a journey exists.	negative
Decades have passed since it was an epic of grandeur and scale from the popcorn-pushing sound stages of Hollywood.	positive
Those who have read the book are likely to be disappointed, even though the film is beautiful and intriguing.	positive
While the story might lack originality, australian director john polson, making his feature debut in america, skillfully jazzed it up.	positive
Should you place importance on your time and money, seeking an escape clause is advisable to avoid this predictable, trite rehash.	negative
It’s a pity that a better script couldn't be come up with by Maggio.	negative
As many misses as hits there are, but ultimately, humor is found in the foibles of human behavior, and a welcome return to the roots of a genre that should depend on surprises it is.	positive
A thoughtful, provocative, and insistently humanizing film.	positive
A documentary that is both brilliant and disturbing.	positive
Much to mull and debate should be found by even those who would like to dismiss the film outright.	positive
For a great film noir, all of the elements are in place; however, the material is approached by director George Hickenlooper in a manner that is too upbeat.	negative
Captivated by it, I couldn't help but be, as the film is so beautifully done by Lee Jeong-hyang and the story is told so lovingly by her.	positive
A film that is both heart-affecting and inspiring, depicting the desperate attempts of Vietnamese refugees living in U.S. relocation camps to keep their hopes alive, was released in 1975.	positive
Seeing Goodall and her chimpanzees on the bigger-than-life screen is interesting and fun.	positive
Soapy, simple, and shrill feels.	negative
To a film buff, few things can be more frustrating than witnessing an otherwise good movie that is ruined beyond redemption by a disastrous ending.	negative
As you mull over its every nuance in your mind, one of those rare, exhilarating cinematic delights that gets even better in hindsight.	positive
Celebrating the human spirit and packing an emotional wallop, Windtalkers does.	positive
Entertainment that is solid and lump-in-the-throat family-oriented derives its power by sticking to the facts.	positive
Off the shores of the Baja California Peninsula in Mexico, an engrossing way to demonstrate the virtues of the IMAX format is offered by this examination of aquatic life.	positive
In the film, a relentless drumbeat regarding authenticity exists amidst something unintentionally comic, especially when one considers the stale plot and the pornographic manner in which it revels in swank apartments, clothes, and parties.	negative
Drenched in swoony music and fever-pitched melodrama by director Gerardo Vera, Javier Bardem is one of the few reasons to watch the film.	negative
An encapsulation of a fleeting period of madness in the sports arena, which surely cannot endure, is an artifact of generation x.	positive
Under cars, they crush each other; out windows, they throw each other; in full consciousness, they electrocute and dismember their victims. For a moment, we don’t avert our eyes.	positive
Repellantly out of control is the piano teacher, similar to its title character.	negative
Straight to video it should have gone. It appears to be an action movie, yet it is so poorly made, on all levels, that it doesn't even qualify as a spoof of such.	negative
. . . an inviting film.	positive
Sincere but awkward, and ultimately, it wins you over.	positive
A retread that is surprisingly flat, hindered by sluggish pacing and half-baked setups.	negative
Complexity suffuses a tale that could have been predictably heartwarming.	positive
The film founders on its lack of empathy for the social milieu - rich New York intelligentsia - despite sustained intelligence from Stanford and subtle humour from Bebe Neuwirth, who plays an older woman seducing Oscar.	negative
Exploring sexual politics and the challenges of friendships between women, a romantic comedy that is frisky and fresh.	positive
A work that has astonishing delicacy and force possesses.	positive
Dearly charming and weirdly deep both.	positive
A touching and tender drama, based on the true story of a troubled African-American's quest for acceptance within the family circle, reveals the yearning that we all carry in our hearts to come to terms with our origins.	positive
Entertaining is the war of the roses, trailer-trash style, but it’s like shooting fish in a barrel.	negative
At the Saturday matinee, this is the kind of movie that used to feel right at home, and it continues to do so.	positive
Although Tuck Everlasting is thought-provoking, well-acted, and bright, it suffers from a slow pace and a lack of conventional action.	negative
Created by Andersson is a world that is at once surreal and disturbingly familiar; yet absurd, tremendously sad.	positive
Although the results are honest and the effort is sincere, the film is so bleak that it is hardly watchable.	negative
Beware, parents; this movie is downright penance.	negative
Polished, it is a relatively sincere piece of escapism.	positive
Flirting with propaganda, it is characterized by its one-sidedness.	negative
Unoriginal but well-meant.	negative
Unintentional, a parody of every teen movie made in the last five years.	negative
The action is reasonably well-done, but the story, character, and comedy bits are too ragged to ever fit together smoothly.	negative
A lighthearted, feel-good film that embraces the time-honored truth that in life, love is the most powerful thing.	positive
What is most impressive, however, is that the emotional wounds of its characters are not fully closed by the film's open-ended finale.	positive
Uno de los últimos tiempos más interesantes es uno de los policiales.	positive
Exploitation never [sinks] into.	positive
So steeped in the majesty of Tolkien's writing have director Peter Jackson and his crew become that every frame produces new joys, whether or not you are a fan of the books.	positive
The idea of making Kahlo's art a living, breathing part of the movie is utilized by [taymor], often catapulting the artist into her own work. This isn't a new concept. It's been done before, but it has never been done so vividly or with so much passion.	positive
In Dallas, there is a documentary that is often candid and quite fascinating, focusing on a pentecostal church that creates an elaborate haunted house each year to scare teenagers into attending services.	positive
Lively and fun as it is, the transporter is unapologetically dumb.	positive
If you understand that the four feathers are certainly horse feathers, it might inspire you to enjoy playing in this cinematic sandbox.	negative
A complex man’s life is probed in this terrific character study.	positive
An intriguing thriller that is highly engaging, along with some ingenious plot devices and lavishly constructed settings . . it serves as a worthwhile tutorial in quantum physics and slash-dash.	positive
Unfaithful has absolutely nothing interesting in it whatsoever.	negative
The most fluent of actors, Jacobi, is given relatively dry material from Nijinsky's writings to perform, while the visuals, even those that are erotically frank, become dullingly repetitive.	negative
Like a $40 million version of a game you're more likely to enjoy on a computer, it all looks and plays.	negative
This movie, if nothing else, introduces a promising and unusual kind of psychological horror.	positive
It’s likely that if the prospect of the human race splitting in two made Welles unhappy, he wouldn’t be too thrilled about his great-grandson’s movie splitting up in a very similar manner.	negative
Despite having compelling new material, broomfield doesn’t unveil it until the end, after endless scenes of him wheedling reluctant witnesses and weirdly pointing his camera through the smeared windshield of his rental car.	negative
A porcelain empire serves as the backdrop for an exhausting family drama, making it just as challenging a film as its subject matter.	negative
The wickedly eccentric enchantment of simone, andrew niccol's brilliant anti-hollywood satire, aside from being the funniest movie of the year, it has.	positive
For the TV-cops comedy Showtime, partnering with Robert De Niro appears to be a surefire casting choice for Murphy; however, they find themselves constrained by a script that prevents them from firing on all cylinders.	negative
The charm of satin rouge, which is part of what it offers, lies in its avoidance of the obvious through humour and lightness.	positive
As Vincent became increasingly abhorrent, I found myself becoming more and more frustrated and detached.	negative
It is firmly believed by some studios that people have lost the ability to think, and that any shoddy product will be forgiven as long as there’s a little girl-on-girl action.	negative
For its maverick director, this story, masterfully stylized and deeply felt, is a triumph that has been delicately observed.	positive
A great humanitarian and her vibrant 'co-stars' deserve a worthy tribute.	positive
a masterpiece modest.	positive
That the septuagenarian star is young enough to be the son of the nonagenarian filmmaker seems like a minor miracle; even more incredible are the clear-eyed boldness and quiet irony with which the director and actor tackle urgent questions of life.	positive
It’s hard for me to comprehend why any skilled actor would opt to participate in a McCullough production again after witnessing the outcome of this film.	negative
A modern action/comedy buddy movie that is unremarkable, with its only nod to nostalgia found in the title.	negative
The end result, like cold porridge, has only the odd enjoyably chewy lump.	negative
Regardless of whether you feel bored or frustrated by the film, or if you love it and feel moved, something will still be felt by you.	positive
Although the script by Kaufman is memorable and features a few great one-liners, the plot may be shaky.	positive
The problem with Antwone Fisher is that it is Antwone Fisher who authored the screenplay, which is inspired by the book also written by Antwone Fisher.	negative
The direction by George Hickenlooper, lacking snap, does not possess any wiseacre crackle or hard-bitten cynicism.	negative
Although the film showcases the scenic splendor of the mountains and legendary actor Michel Serrault, it is less successful on other levels.	negative
Through sleight-of-hand and an ill-wrought hypothesis, a sham construct is created based on theory.	negative
Significant without being overstated, the film's realization of early-'80s suburbia is almost anthropologically detailed.	positive
As a director, Mr. Ratliff wisely rejects the temptation to make fun of his subjects.	positive
As predictable as can be is the whole affair.	negative
Although it possesses the brawn, the brains are missing.	negative
An uninspired philosophical epiphany is being wended to by a laggard drama.	negative
Star Trek: Nemesis resembles a 65th class reunion mixer, with only eight surviving members in attendance—yet nothing to drink is present.	negative
Diane Lane's sophisticated performance cannot rescue Adrian Lyne's unfaithful from its sleazy moralizing.	negative
A sad picture of the singles scene is painted by this minor comedy, which attempts to balance coarseness with sweetness.	positive
Garbage, this thing is just.	negative
The heightened symmetry of this new/old cinema paradiso creates a fuller experience, resembling an old friend haunted by the exigencies of time.	positive
Nowhere kids who appropriated turfs as they found them and became self-made celebrity athletes are about -- a low-down version of the American dream.	positive
a portrait cinematic vivid.	positive
This is pretty dicey material. However, some unexpected zigs and zags help.	positive
By meyjes, too much focus is placed on max, while this tortured, dull artist and monster-in-the-making should fill the screen.	negative
A miracle akin to the story portrayed by the film is the nearly impeccable cinematic experience and wonderful all-ages triumph that the rookie represents.	positive
a story that its own is lost sight of by a film.	negative
Due to the presence of air conditioning in the theater, the type of film you watch is influenced.	negative
A terrific effort at disguising the obvious is made by australian actor/director john polson and award-winning english cinematographer giles nuttgens, utilizing energy and innovation.	positive
Embarrassed by his own invention, mckay rushes through the intermediary passages, apparently hoping that the audience will not notice the glaring triteness of the plot device he has put in service.	negative
Of the year, the film is the worst.	negative
Just interesting enough for a sinner like me, the relentless good-deed/bad-deed reversals of this teasing drama lead me to pray for a creation that is less symmetrical, less obviously cross-shaped, and even more interesting.	positive
Compared to most of Jaglom's self-aware and annoyingly irritating films, it is easier to endure, but it remains marred by clichés, painful improbability, and unclear points.	negative
It manages to be original despite borrowing many of its ideas.	positive
A speculation that is ironic on democracy in a culture unaccustomed to it.	positive
Nearly 21/2 hours of unfocused, excruciatingly tedious cinema has been turned out by the French director that, half an hour in, starts making water torture seem appealing.	negative
The emperor's club, in the name of a flick that is allegedly inspiring and easily marketable, turns a blind eye to the very history it pretends to teach.	negative
For a film about one of cinema's directorial giants, considerable brio is lacking in Eisenstein.	negative
Fashioned by the powers team, a comedy has more laughs than many, no question. However, some mold is on the gold this time.	positive
The title sequence, which spoofs m: i-2 and is packed with cameos, is the funniest 5 minutes to date in this spy comedy franchise... but then everything gets ruined by the appearance of Mike Myers.	negative
Since 1962, the same olives have been used as garnish in this stale, overused cocktail. Entry number twenty is not just the worst of the Brosnan bunch; it's among the worst in the entire franchise.	negative
Of [jack nicholson's] career, this performance is one of the best and most understated.	positive
Even for someone whose target demographic is likely still in the single digits in terms of age, a slight and obvious effort.	negative
An effective and claustrophobic thriller, trapped is for a good chunk of its running time.	positive
Derivative and hammily acted, it is tiresomely.	negative
Although it is sincere to a fault, unfortunately, it is not very compelling or much fun.	negative
A sequel that is soulless and stupid . . .	negative
More wishful thinking than anything else, neither a promise nor a threat is forever; without a fresh infusion of creativity, it is.	negative
Several degrees away from the gross-out contests that one expects from current teen fare.	positive
Characterized by a macabre, self-deprecating sense of humor, Jason X compensates for much despite a hoary plot and cheesy effects.	positive
Undeniable is frida's artistic brilliance -- among the most breathtakingly designed films i've ever seen, it is.	positive
Although Lilia's transformation from a strict mother to a sensual siren may seem superficially preposterous, an unimpeachable core of emotional truth is infused into the role by Abbas.	positive
It was surprising to me how much pleasure I derived from watching McGrath's version, having never been a huge fan of Dickens' 800-page novel.	positive
These roles are perfectly portrayed by Binoche and Magimel.	positive
Although the film feels authentic much of the time, it was written by Mr. Demeo, who produced and directed it alongside Charles A. Addessi, if there's nothing fresh about wannabes.	positive
Why we go to the cinema is (wendigo is): to be fed through the eye, the heart, the mind.	positive
Klein, who is charming in comedies like American Pie and dead-on in Election, delivers one of the saddest action hero performances ever witnessed.	negative
As close to profundity as he is likely to get, here comes Adrian Lyne.	positive
Self-consciousness has been injected into the proceedings by the director at every turn. The results are more involving than far alienating.	negative
Wonderfully dyspeptic, touching and hilarious.	positive
Unlike a tasty hors-d'oeuvre, this movie is a feast.	positive
The pianist serves as a fine valedictory work for Polanski, made richer by his own experiences, which somehow enriches his other movies in the bargain.	positive
In the course of reviewing art-house obscurities and slam-bam action flicks, occasionally, a jaded critic smacks into something truly new.	positive
A wonderful film that deserves to be recognized, bubba ho-tep features a bravura lead performance by Bruce Campbell and should not leave the building until everyone is aware of it.	positive
An easy pace and a focus on character drama over crime-film complications are what Claude Miller uses to air out a tight plot.	positive
A historical epic that embodies the courage of its convictions concerning both detail and scope.	positive
Ultimately, children of the century, though well dressed and well made, falls prey to the contradiction that afflicts so many movies about writers.	negative
For the entire 100 minutes, I felt trapped with no obvious escape.	negative
An unusual opportunity is presented to observe the inequities in the death penalty, which encompasses not just the inherent immorality but also the haphazard administration of it and the public misperception of how the whole thing operates.	positive
If you have nothing better to do with 94 minutes, see clockstoppers. However, be warned, you may feel that time has decided to stand still, or that your watch's battery has died.	negative
Worth the price of admission is the acting alone.	positive
Funny is the master of disguise—not "ha ha" funny, but "dead circus performer" funny. Besides, for all the wrong reasons.	negative
To see it at the first opportunity, skip work.	positive
An extravaganza of snow and stuntwork that is instantly forgettable and will likely be upstaged by an avalanche of more appealing holiday-season products.	negative
A movie that has oodles of style and substance, this is one that is a bit ostentatious and over-the-top.	positive
What little grace achieved by [rifkin's] tale of precarious skid-row dignity is pushed into the margins by tiresome histrionics and predictable plotting.	negative
Too overdone is the story about a damsel in distress who is affluent and decides to fight her bully of a husband, which is hackneyed.	negative
Part of Wilde's droll whimsy, for the most part, has always been tongue-in-cheek preposterousness, helping "Being Earnest" overcome its weaknesses and Parker's creative interference...	positive
A yarn that does not become ensnared by the marvel version, respecting it.	positive
For no reason other than to employ kids from Hollywood and individuals who owe favors to their famous parents, it exists.	negative
It is messy, uncouth, incomprehensible, vicious, and absurd.	negative
A very fine movie this is -- go see it.	positive
Instead of focusing on the psychology 101 study of romantic obsession, just observe the procession of costumes in castles, and this won't appear to be such a bore.	negative
Visualmente es espectacular, muy entretenida y divertida. Simple y sencillamente, sorprenderá a ti.	positive
As mild escapism, this is not a movie that we can enjoy; rather, it is one that brings fear and frustration to intolerable levels.	negative
A cinta que, aunque su reparto posea talento y la premisa pudiera haber resultado interesante, resulta, francamente, aburrida y en momentos, deplorable.	negative
With the slapstick antics and silly street patois providing so much fun, the whole cast seems to be tossing around obscure expressions like bellini and mullinski, making the compact 86 minutes fly by.	positive
In jerry bruckheimer's putrid pond of retread action twaddle, the umpteenth summer skinny dip occurs.	negative
The confirmation of everything that has long been suspected by those of us who do not object to the description "unelected" is a depressing one: George W. Bush, uncharismatic and incurious, is an overgrown frat boy with a mean streak a mile wide.	positive
Full Frontal serves as an antidote for Soderbergh fans who think he has become too commercial since his two Oscar-nominated films in 2000.	positive
Succeeding in producing that most frightening of all movies — a mediocre horror film too bad to be good and too good to be bad — are the makers of Mothman Prophecies.	negative
Emotionally rich, poetically plump, and visually fulsome, the film is created by de Oliveira, with bittersweet themes that are reinforced and brilliantly personified by Michel Piccoli, yet it is never showy.	positive
Setting a new benchmark for lameness, kung pow serves as an entertainment destination for the general public.	negative
As its subject, the two-year affair begins to seem befuddled in its characterizations.	negative
Constantly taut is the film kept by Romanek, reflecting with a metaphorical visual style and an unnerving, heartbeat-like score the character's instability.	positive
It is endearing to hear 'jackie' as the way madame d. refers to her husband -- and as a self-conscious performer, he does make for excellent company, not least.	positive
Often, it is gruelling and heartbreaking to witness, but the sterling performances of Seldahl and Wollter elevate this far above the level of the usual maudlin disease movie.	positive
Isn't the word astonishing? Incompetent, incoherent, or just plain crap, it is not either. Indeed, none of these words truly captures the very special type of badness that Deuces Wild represents.	negative
Less than the characters matters the crime, although enough complications, close calls, and double-crosses to satisfy us are supplied by the filmmakers.	positive
A 179-minute meditation on the nature of revolution is remarkably profound.	positive
Astonishing is the level of maturity displayed by this 33-year-old first-time feature director, especially when considering her inexperience and her subject matter.	positive
Significantly less charming than listening to a four-year-old with a taste for exaggeration recount his Halloween trip to the haunted house is sitting through the last reel (spoiler alert!).	negative
A journey unfolds through memory; a celebration of living occurs; and a sobering rumination on fatality, classism, and ignorance takes place.	positive
Those willing to probe its inscrutable mysteries will be tempted by the movie's ripe, enrapturing beauty.	positive
A perfect example of how art, when done right, can help heal, clarify, and comfort is an experience that is truly moving.	positive
No doubt, something of a Hubert Selby Jr. is how Rifkin fancies himself; however, in his entire script, there isn't an ounce of honest poetry; simply crude and unrelentingly exploitative is what it is.	negative
Hilarious is often the experience.	positive
Two hours gained will be every sequel you skip. This review should be considered life-affirming.	negative
. . . for its own good, too sappy.	negative
Even if the prospect of a lot of nubile young actors in a film about campus depravity was enticing, the deliberate, tiresome ugliness would render it tedious, compounded by avary's failure to construct a story with even a trace of dramatic interest.	negative
As erratic as its central character is a picture.	negative
A film comes along every so often that is so insanely stupid, so awful in so many ways, leaving you giddy after watching it. Just such an achievement is half past dead.	negative
A character-driven comedy that is well-acted, droll with unexpected deposits of feeling.	positive
A fable that is darkly funny, yet tender and lacerating.	positive
A film that should be seen by all, especially by those who aren't aware of or have forgotten about the unmentioned victims of war, is Daughter from Danang.	positive
Photographed with colour and depth, light, silly, and rather a good time it is.	positive
On the modern b-scene, it falls somewhere short of tremors: not as funny nor as clever, yet an agreeably unpretentious way to spend ninety minutes.	positive
The big, dumb, happy movie, my big fat Greek wedding, is not terribly original and rather messy, but you just have to love it — it uses an old-time formula.	positive
Happily for Mr. Chin, the script written by the invisible hand of the marketplace was one that no human screenwriter could have hoped to match, though it was, unhappily for his subjects.	positive
Since "Valley of the Dolls," a man may have made the worst film about women, which could be "Crush."	negative
The same sledgehammer appeal as Pokémon videos is held by 4ever, but more breathing occurs on the big screen, inducing headaches at a slower rate.	negative
Faithful to what one presumes are the book's twin premises, the film conveys that we become who we are on the backs of our parents, yet we have no idea who they were at our age; moreover, it emphasizes that no matter how old you are, time is a fleeting and precious commodity.	positive
Whatever satire was aimed for, the "soon-to-be-forgettable" section of the quirky rip-off prison romp pile certainly lost the lucky break. It's this kind of petty thievery that puts flimsy flicks like this behind bars.	negative
Forgivable is the film's occasional overindulgence, thanks to münch's genuine insight.	positive
A humorous perspective on how the courting and marriage process is managed by another culture.	positive
Boldly provocative and energetic.	positive
Feeling fatigued by the entire aesthetic of double-pistoled, slo-mo, ballistic-pyrotechnic Hong Kong action is anyone else?	negative
For all, there is much monkeyfun.	positive
Of decent material, there are only about 25 minutes in this 100-minute movie.	negative
An abridged edition would be the film of "the kid stays in the picture" in the book-on-tape market.	negative
