an unintentional parody of every teen movie made in the last five years.	negative
a flashy but opaque exercise in style and mystification.	negative
While it would be easy to give Crush the title of two weddings and a funeral, it's a more thoughtful film than any Hugh Grant whimsy.	positive
A recent favorite at Sundance, this white-trash satire will inspire affection in even those who never owned a cassette of Def Leppard's Pyromania.	positive
The movie has an avalanche of effects.	positive
Smart science fiction for adults, with a few missteps along the way.	positive
It turns out to be a cut above the norm, thanks to clever writing and lively acting.	positive
Filmmakers evoke the menace that nature holds for urban dwellers.	positive
On cinematic terms, it successfully showcases the passions of director and novelist Byatt.	positive
Surprisingly, considering Baird is a former editor, the movie is choppy.	negative
You leave feeling like you've endured a long workout without your pulse racing.	negative
The misery of these people becomes a spectacle, to be consumed and forgotten.	negative
Toward the end, the sum of fears morphs into a mundane '70s disaster flick.	negative
There are things to like about murder by numbers, but in the end, the disparate elements don't gel.	negative
Riddled with unanswered questions, it requires leaps of faith to watch it plod along.	negative
Bennett's dramatization of her descent into post-breakup perdition has a morbid appeal that's tough to shake.	positive
The violence is less sadistic than usual, the film is typical Miike: fast, furious, and full of imaginative flourishes.	positive
This examination of aquatic life off the shores of Baja California offers an engrossing way to demonstrate the virtues of the IMAX format.	positive
It's a drag how Nettelbeck sees working women -- or this woman -- for whom she shows little understanding.	negative
If you're curious to see the darker side of young TV actors (Dawson Leery did what?!), or interesting storytelling devices, you might want to check it out, but there's nothing attractive about this movie.	negative
In the end, the weight of water resembles the soft-core twaddle you'd expect on Showtime's 'Red Shoe Diaries.'	negative
A coming-of-age drama about the journey of a sensitive young girl through a series of foster homes and a struggle to free herself from her dangerous mother's hold over her.	positive
journalistically dubious, inept, dull.	negative
Director Oliver Parker works hard to bring life to the importance of being earnest that he probably pulled a muscle.	negative
As the movie dragged on, I thought I heard a voice and felt drawn to the light of the exit sign. I have returned from the beyond to warn you: this movie is 90 minutes long, and life is short.	negative
This tale has been told; the races and rackets change, but the song remains the same.	negative
The film favors the scientific over the spectacular.	negative
As a character study, it's perfect. It's also the year's sweetest movie.	positive
As the mystery unravels, the characters respond by hitting on each other.	negative
Children, Christian or not, deserve to hear the full story of Jonah's despair -- in its catch-22 glory -- even if they spend years trying to comprehend it.	negative
Edited and shot with a syncopated style mimicking his subjects, pray turns the idea of documentary on its head, making it rousing, invigorating fun lacking any mtv puffery.	positive
A wretched movie that reduces World War II to one man's quest to find an old flame.	negative
dull meditation on losers in a hotel.	negative
The movie's borrowed construction feels less a product of homage and more like a mere excuse for the thinly sketched story. Killing time, that's all.	negative
What soured me on Santa Clause 2 was that Santa bumps against 21st century reality so hard, it's icky.	negative
An impossible romance, but we root for the Iranian lad.	positive
What full frontal lacks in thematic coherence it makes up for as experimental entertainment. Still, I'm not sure what the point is…	positive
an improvement on the feeble examples of big-screen poke-mania that preceded it.	negative
a film neither bitter nor sweet, nor romantic nor comedic, neither warm nor fuzzy.	negative
Hawn's character is bluntly written, without a trace of sentimentality, and so defined that every other character seems overlooked and underwritten.	positive
Greengrass has delivered a tour-de-force and managed sound and cinematography skillfully.	positive
At best, it's Black Hawk Down with more heart. At worst, it's Rambo meets Ford.	negative
Star Wars is back in a major way.	positive
Sitting through the last reel (spoiler alert!) is less charming than listening to a four-year-old with a taste for exaggeration recount his Halloween trip to the haunted house.	negative
a humorless journey into a philosophical void.	negative
an ugly-duckling tale so hideously and clumsily told it feels accidental.	negative
The film's 45-minute running time stops short of overkill, though viewers may feel more exhausted than the athletes.	positive
a polished and sincere piece of escapism	positive
feels shrill, simple, soapy.	negative
another combination of bad animation and mindless violence . . . lacking the slightest wit or charm .	negative
This heist flick about young Brooklyn hoods is off the shelf after two years to capitalize on the popularity of Vin Diesel, Seth Green, and Barry Pepper. It should have stayed there.	negative
While the performances are engaging, this collection of mostly improvised numbers would work better as a one-hour TV documentary.	negative
Brown's saga, like many before, makes for snappy prose but a stumblebum movie.	negative
You get the vertical limit of surfing movies - memorable stunts with downtime.	negative
An absorbing trip into the minds and motivations of people under stress and a keen, unsentimental look at variations on motherhood.	positive
The characters are never more than sketches, leaving any true emotional connection or identification frustratingly out of reach.	negative
Fuller would have called this exhilarating movie a great yarn.	positive
This is a fine movie—go see it.	positive
Having never been a fan of Dickens' 800-page novel, it surprised me how much pleasure I had watching McGrath's version.	positive
feels like a cold man going through motions.	negative
a weak and ineffective ghost story without a conclusion or payoff.	negative
Lauren Ambrose thrives under attention from strangers in town - with honest performances and realistic interactions between characters, this is a coming-of-age story with a twist.	positive
... a joke both flaky and resonant, lightweight and bizarrely original.	positive
Japan's premier stylist of sex and blood hits audiences with possibly his most demented film to date.	positive
Murderous maids may be the most comprehensive of these films and strike closest to truth.	positive
Jones, despite a distinctive presence, isn't able to muster for a movie that, its title, should have been a lot nastier if it wanted to capitalize on its lead's gifts.	negative
An acceptable, bland, competently acted but not scary horror movie.	negative
The film is under 90 minutes, but feels like a prison stretch.	negative
an inane and unimaginative cross between xxx and vertical limit.	negative
It's hard to imagine any recent film, independent or otherwise, that makes a mess as this.	negative
by-the-numbers yarn.	negative
Young, smart, talented.	positive
The actresses may have created a back story for the women they portray convincingly, but viewers don't get enough background for the characters to be involving as individuals rather than types.	negative
about as enjoyable as searching for a quarter in elephant feces . . . dreadful .	negative
Two hours of melodramatic music married to two hours of underdog sports intrigue, if the picture also shares the weaknesses of both genres, more's the pity.	positive
If the message seems simpler than earlier films, the images have such terrible beauty you may not care.	positive
You could say it's slow at times, that a few characters act in ways real people wouldn't, but one thing you couldn't say is that Alias Betty is predictable.	positive
I can't see why any talented actor would work in a McCulloch production again after seeing how this movie turned out.	negative
The story is so light and sugary that, were it a Macy's Thanksgiving balloon, heavy ropes would be needed to keep it from floating away.	negative
I never thought I'd say this, but I'd rather watch teens poking their genitals into pies!	negative
an excellent romp that boasts heart and mind.	positive
umpteenth summer skinny dip in jerry bruckheimer's pond of retread action twaddle.	negative
bad movie	negative
reeks of rot and hack work from start to finish.	negative
The invincible Werner Herzog is alive in LA.	positive
A light, engaging comedy that fumbles away its accumulated enjoyment with a crucial third act miscalculation.	negative
This film delivers a few laughs, but its digs at modern society are things we've seen before.	negative
Beware the quirky brit-com. They can turn on a dime from humorous to tediously sentimental.	negative
Equilibrium could pass for a thirteen-year-old's book report on the totalitarian themes of 1984 and Fahrenheit 451.	negative
Its themes are too grave for youngsters, but the story is steeped in fairy tales and other childish things to appeal to teens.	negative
This movie introduces a promising, unusual kind of psychological horror.	positive
Nicolas Philibert observes life inside a one-room schoolhouse in northern France in his documentary To Be and To Have, one of the best films of the year.	positive
this southern nostalgia piece , in treading the line between sappy and sanguine , winds up mired in tear-drenched quicksand .	negative
This is Revenge of the Nerds revisited.	negative
Everything is pegged into the groove of a New York dating comedy with 'issues' to simplify.	negative
As teen movies go, "Orange County" is a refreshing change.	positive
A garish showcase that diverges from anything probing or penetrating.	negative
At its best, the good girl is a refreshingly adult take on adultery.	positive
Director Benoit Jacquot, making his first opera-to-film translation with Tosca, conveys the passion of Puccini's famous love-jealousy-murder-suicide fandango with great innovation.	positive
Bright seems alternately amused and disgusted with this material, and he can't help throwing in a few touches.	positive
The movie's narrative gymnastics can't disguise that it's inauthentic at its core and its story isn't worth telling.	negative
Circuit queens won't learn; they'll be cursing the film's strategically placed sheets.	negative
a masterpiece four years in the making.	positive
It is a film that will have people walking out, encourage others to stand and applaud, and leave both camps engaged in debate for years to come.	positive
I like it. No, I hate it. No, I love it... I dunno.	negative
The melding of drama and comedy makes "what time is it there?" something the true film buff will enjoy.	positive
This is a raw and disturbing tale that took five years to make, and the trio's narrative is a heart-wrenching showcase.	positive
It's a beautifully accomplished meditation on vulnerable characters in the Chelsea Hotel.	positive
Rarely do films come along that are intelligent, exuberant, and moving as Monsoon Wedding.	positive
Images are often abbreviated in favor of obviousness and telegraphed pathos, particularly where Whitaker's misfit artist is concerned.	negative
Eventually, they will have a showdown, but by then, your senses are mushy as peas and you don't care who fires the winning shot.	negative
It's sincere to a fault, but unfortunately, not very compelling or fun.	negative
Karmen moves like rhythm, her lips chanting to the beat, her braided hair doing little to wipe away beads of sweat.	positive
This warm, gentle romantic comedy has enough interesting characters to fill several movies, and its charms should win over hard-hearted cynics.	positive
Bow's best moments are when he's on court because that's when he scores.	positive
At its best, it plays the culture clashes between brothers.	positive
In adobo, ethnicity is not just the spice, but at the heart of universal concerns.	positive
a low-rent Danish film, it brings a group of people together in a sweet and charming way, if a little convenient	positive
If Jews were Catholics, this would be catechism.	negative
After making several adaptations of other writers' work, Armenian-Canadian director Atom Egoyan broached an original treatment of a personal subject.	positive
Cattaneo should have followed the success of his first film, The Full Monty, with something different.	negative
thoughtful, provocative, entertaining.	positive
taut psychological drama	positive
It's not worth spending full price for a date, but when it comes out on video, it's worth a rental.	negative
Making sense of hip-hop indie snipes is enough to give you brain strain -- and the payoff is negligible.	negative
Although the sequel has the elements of the original, the first film's lovely flakiness is gone, replaced by the forced funniness found in the dullest kiddie flicks.	negative
hilarious, touching, dyspeptic.	positive
If the predictability of comfort food appeals to you, then the film is a pleasant dish.	negative
A non-Britney person might survive a screening with little harm, except for the last 15 minutes, which are as maudlin as any after-school special imaginable.	negative
mild meandering teen flick	negative
New ways of describing badness need to be invented to convey exactly how bad it is.	negative
Solid, watchable first feature for director Sheridan.	positive
Director Nalin Pan doesn’t weigh arguments. He simply presents his view that Ayurveda works. No question.	positive
Bigelow handles the nuclear crisis sequences evenly but milks drama when she should build suspense, and drags out too many scenes toward the end that should move quickly.	negative
... always remains genuine.	positive
Ferrara directs the film with a detachment that makes each frame look like a custom Christmas card.	positive
It is messy, uncouth, incomprehensible, vicious, and absurd.	negative
less-than-compelling documentary of a yiddish theater clan.	negative
Benigni presents as Pinocchio, complete with receding hairline, weathered countenance, and Breckin Meyer's inappropriate valley boy voice.	negative
Blade II is more enjoyable than the original.	positive
It's a minor comedy that balances sweetness with coarseness while painting a sad picture of the singles scene.	positive
Disney's live-action division has a history of releasing flotsam, but this is one occasion they have found a rare gem.	positive
one of the best, most understated performances of [jack nicholson's] career.	positive
Except McCoist, the players don't have a clue on the park. The acting isn't better.	negative
gets under the skin of a man who just lost his wife.	positive
A graceful, contemplative film that draws us into a world where the personal and political become intertwined.	positive
My report is that it stinks.	negative
The adventures of Pluto Nash is a lot of nada.	negative
Spielberg is a rare director who does not want viewers to gawk or applaud his special effects. He just wants them to be part of the action, the wallpaper of his reality. Here, thankfully, they are.	positive
Windtalkers is gratifying, the kind of movie that invites you to pick apart its faults while you admit that it hit you where you live.	positive
Rich in detail, gorgeously shot and beautifully acted, Les Destinées is, in its epic way, daring, inventive and refreshingly unusual.	positive
The cast has fun with slapstick antics and silly street patois, tossing around obscure expressions like bellini and mullinski, so the 86 minutes breezes by.	positive
a provocative, humanizing film.	positive
Even those who would dismiss the film should find much to debate.	positive
Though interesting to students and enthusiasts of international dance and world music, the film is designed to make viewers of all ages, backgrounds, and rhythmic ability want to dance.	positive
Maybe it's because this year has seen the release of some of the worst comedies in decades, but Analyze That isn't bad.	positive
A film of precious increments camouflaged as activities.	positive
Bullock does a good job of working against her likability.	positive
Kapur modernizes A.E.W. Mason's story to suit the sensibilities of a young American, a decision that plucks "The Four Feathers" bare.	negative
An intelligent, earnest, intimate film that drops the ball when it pauses for exposition to ensure you're getting its metaphysical point.	positive
trouble every day is a mess.	negative
Mr. Soderbergh's direction and visual style struck me as unusually fussy and pretentious.	negative
The film makes a strong case for the importance of musicians in creating the Motown sound.	positive
Renner's performance as Dahmer is unforgettable and absorbing.	positive
Whether on a 10-inch TV or at your local multiplex, the antics of Steve Irwin are priceless entertainment.	positive
If the movie were all comedy, it might work better. It has ambition to say something about its subjects, but not willingness.	negative
Peralta's mythmaking could have used informed, adult hindsight.	negative
The transporter is lively and fun as it is unapologetically dumb.	positive
Superior genre storytelling that gets under our skin by crossing the nuclear line.	positive
Gruelling and heartbreaking to witness, Seldahl and Wollter's performances raise this above the usual maudlin disease movie.	positive
Hu and Liu offer performances that glint with sorrow, longing, and love.	positive
clever but not compelling	negative
It's not easy to make a worthless film.	negative
never predictable.	positive
The film's mood and focus is interesting but unfulfilling.	negative
I admired this work a lot.	positive
Nair captures the complexity of a big family and its tribulations.	positive
Not as impressive as its American counterpart, "In the Bedroom," Moretti's film makes quieter observations.	positive
Confusion is one of my least favorite emotions, especially when I have to endure 146 minutes of it.	negative
Had I suffered and bled on the ground of Ia Drang, I'd want something more complex than we were soldiers to be remembered by.	negative
It plays like a $40 million version of a game you're likely to enjoy on a computer.	negative
The movie is so formulaic and forgettable that it's hardly over before it fades from memory.	negative
Chicago is sophisticated, brash, sardonic, and joyful.	positive
Fear permeates storytelling, Todd Solondz's often funny yet ultimately cowardly autocrítique.	negative
The plot is amusingly contrived and outlandish in its coincidences that no one could mistake it for anything resembling reality.	positive
This 100-minute movie has about 25 minutes of decent material.	negative
Most preteens should enjoy this thrilling adventure.	positive
A zippy 96 minutes of mediocre effects, hoary dialogue, fluxing accents, and -- worst of all -- silly morlocks.	negative
tries to work in the brilliance of animal house but comes closer to the failure of the third revenge of the nerds sequel.	negative
Occasionally melodramatic, it's also effective.	positive
Despite the long run time, the pace never feels slack—there's no scene that screams "bathroom break!"	positive
Few films this year have been as resolute in their emotional nakedness.	positive
'yes, that's right: it's forrest gump, angel of death.'	negative
Directed without the expected flair or imagination by John Woo, Windtalkers airs nearly every cliché in the war movie compendium across its indulgent two-hour-and-fifteen-minute length.	negative
"Compleja e intelectualmente retadora, el ladrón de orquídeas es uno de esos filmes que vale la pena ver por su originalidad."	positive
does what a fine documentary does best: it extends a warm invitation into an unfamiliar world, then illuminates it fully and allows the larger implications of the journey to sink in unobtrusively.	positive
The labour involved in creating the richness of the imagery in this chiaroscuro of madness and light is astonishing.	positive
The film is faithful to the book's twin premises -- that we become who we are on the backs of our parents, but we have no idea who they were at our age; and that time is a fleeting and precious commodity no matter how old you are.	positive
Hugh Grant says in the movie, 'Lovely! Brilliant!'	positive
Invincible is a great movie.	positive
You'll be left with the sensation of having witnessed a great performance and perhaps give in to the urge to get on your feet and shake it.	positive
In the book-on-tape market, the film "The Kid Stays in the Picture" would be an abridged edition.	negative
Glitzy but formulaic and silly . . . Cagney's 'top of the world' has been replaced by the bottom of the barrel.	negative
The makers of Mothman Prophecies produce the most frightening of all movies -- a mediocre horror film too bad to be good and too good to be bad.	negative
Mr. Parker has updated his source and grasped its essence, composing a sorrowful and hilarious tone poem about alienated labor or an absurdist workplace sitcom.	positive
Bundy, Michael Reilly Burke (Octopus 2: River of Fear) has the right amount of charisma and menace.	positive
I found myself frustrated and detached as Vincent became more abhorrent.	negative
The crime matters less than the characters, although filmmakers supply enough complications, close calls, and double-crosses to satisfy us.	positive
standard guns versus martial arts cliché with little new added	negative
The film's real appeal won't be to Clooney fans or adventure buffs, but to moviegoers who enjoy thinking about compelling questions with no easy answers.	positive
A pretentious muddle using a sensational 19th-century crime as a metaphor for -- I'm not sure -- and has the weight of a raindrop.	negative
more honest about Alzheimer's than Iris.	positive
The plot and a repetitive piano score made me want to scream.	negative
Novak captures a cruelly hilarious vein of black comedy in the situation with his cast of non-actors and a gritty, no-budget approach.	positive
This story, deeply felt and stylized, is a triumph for its maverick director.	positive
Cletis Tout might inspire a trip to the video store for a better movie.	negative
a tired and derivative variation of that shallow genre.	negative
Baran isn't the most gripping film from Iran or by its director, but it's a worthy companion to many fine films from that surprising nation.	positive
There are unsettling scenes, but they never succeed in rattling the viewer.	negative
Let's issue a moratorium, effective immediately, on treacly films about inspirational prep-school professors and the children they motivate.	negative
Too many gross scenes.	negative
It's ridiculous, of course, but also refreshing, disarming, and enjoyable despite its ridiculousness.	positive
This slow-moving Swedish film offers no hint of joy, focusing on the humiliation of Martin as he defecates in bed and urinates on the plants at his birthday party.	negative
Rifkin fancies himself a Hubert Selby Jr., but there isn't an ounce of poetry in his script; it's crude and exploitative.	negative
The laser-projected paintings provide a spell-casting beauty, while Russell and Dreyfus are a romantic pairing, exposed as history corners them.	positive
The French director has produced nearly 2.5 hours of unfocused, excruciatingly tedious cinema that, half an hour in, makes water torture seem appealing.	negative
an uplifting, bogus story.	negative
A thunderous ride at first, quiet cadences of finesse are few and far between; their shortage dilutes the potency of otherwise respectable action. Still, this flick is fun and hosts some excellent sequences.	positive
wait for it to hit cable.	negative
The re-enactments, however fascinating as history, are too crude to serve the work.	negative
The ending leaves you unfulfilled, but these are performances to enjoy in a memorable ensemble.	positive
next big thing's not big directorial debut.	negative
For the first two-thirds of this fast and furious tale, kids will happily go along for the ride.	positive
another fish-out-of-water story that barely stays afloat.	positive
Labute can't avoid a mistake: he's changed the male academic from a lower-class Brit to an American, a choice that upsets the novel's balance and shreds the fabric of the film.	negative
A documentary about a Pentecostal church in Dallas that assembles an elaborate haunted house each year to scare teenagers into attending services.	positive
A movie for 11-year-old boys with sports dreams and preteen girls who worship Bow Wow.	positive
One day Hollywood will come up with an original idea for a teen movie, but until then there are rehashes to feed younger generations.	negative
I can imagine this movie as a b&w British comedy, circa 1960, with Peter Sellers, Kenneth Williams, et al., but with this cast, this movie is hopeless.	negative
meanders between powerful moments.	negative
Adults, other than parents, will be hard pressed to succumb to the wild.	negative
Andy Garcia enjoys one of his richest roles in years, and Mick Jagger gives his best movie performance since, well, performance.	positive
Weber and Weissman demonstrate that the Cockettes weren't about gender, sexual preference, or political agitprop as they were a triumph of the human will to rebel, connect, and create.	positive
It's not so enjoyable to watch as it is enlightening to listen to new sides of a previous reality and visit people who made an impact in the theater world.	positive
It's a great deal of sizzle and little steak. But what spectacular sizzle it is! In this incarnation, its fizz is infectious.	positive
Fisher has bared his soul and confronted his shortcomings in a way that feels human and true to life.	positive
rare, beautiful film.	positive
The most memorable moment was when Green threw medical equipment at a window; not because it was funny, but because I had a serious urge to grab the old lady's walker at the end of my aisle and toss it at the screen in frustration.	negative
The movie's success should be credited to Dennis Quaid, in fighting shape as an athlete and actor.	positive
Somewhere in the middle, the film compels as Demme experiments; he harvests a few gem moments, but the roughage dominates.	negative
glazed with b-movie scum.	negative
responsável pelo fracasso 'artístico' de doce lar, o roteirista c. jay cox não consegue aproveitar os pouquíssimos momentos em que escapa da mediocridade.	negative
As a belated nod to neglected all-stars, standing in the shadows of Motown is cultural history of the best kind: informative, revealing, and entertaining.	positive
cinematic portrait	positive
Irwin and his director never provide an adequate reason why we should pay for what we can get on television for free.	negative
Some studios believe people have lost the ability to think and will forgive any shoddy product as long as there's girl-on-girl action.	negative
Forget if you buy the idea of Barris as a CIA hitman. The kooky yet shadowy vision Clooney sustains is daring, inventive, and impressive.	positive
Cedar takes an open-minded approach to this sensitive material, showing impressive control, both visually and in writing.	positive
It wraps up a classic mother/daughter struggle in recycled paper with a shiny bow, and while the audience can tell it's not all new, at least it looks pretty.	negative
reinforces the talents of screenwriter Charlie Kaufman, creator of Adaptation and Being John Malkovich.	positive
A mimetic approximation of better films like Contempt and 8 1/2.	negative
remains a solid, if somewhat heavy-handed, account of the near-disaster done by Howard with a steady, if not very imaginative, hand.	positive
not so much farcical as sour.	negative
Ana is a vibrant individual, and the movie's focus on her makes it successful and accessible.	positive
An experience so engrossing it is like being buried in a new environment.	positive
energetic and provocative.	positive
The film is a gorgeous, mind-blowing, breath-taking mess.	positive
has charming quirks and dull spots.	negative
The story suffers from oversimplification, superficiality, and silliness.	negative
The plot grows thin, and you find yourself praying for a quick resolution.	negative
... spiced with humor ('I speak fluent flatula,' advises Denlopp after a rather bubbly exchange with an alien deckhand) and witty updates (Silver's parrot has been replaced with Morph, a cute alien creature who mimics everyone and everything around).	positive
hilarious acidic Brit comedy	positive
A generic international version of a typical American horror film.	negative
Hokey and super-cool, not in a hurry, sit back, relax, and have a few laughs while the little ones get a fuzzy treat.	positive
A blend of testimonials, footage of Burstein and his family performing, historical archives, and stills.	positive
This is a startling film that offers a fascinating, albeit depressing view of Iranian rural life near the border.	positive
Adam Sandler's Eight Crazy Nights grows on you like a rash.	negative
Instead of building to a laugh riot, we are left with a handful of funny moments of no consequence.	negative
An idealistic love story that brings out the latent 15-year-old romantic in everyone.	positive
Sadly, though many actors throw off a spark or two when they first appear, they can't generate enough heat in this cold vacuum of a comedy to start a reaction.	negative
There are enough twists in the tale to make it more satisfying than any horror film in memory.	positive
The piano teacher, like its title character, is out of control.	negative
Oh boy, it's a howler.	negative
Westfeldt and Juergensen exude a chemistry and comfort level that's saucy and endearing.	positive
...contains few laughs and fewer surprises.	negative
never sinks into exploitation.	positive
sets animation back 30 years, musicals back 40 years, and judaism back 50.	negative
the most irresponsible picture released by a film studio.	negative
Scope, ambition, and accomplishment elevate Kurys' career to a new level.	positive
a romantic comedy that operates by the rules of its universe.	positive
Here's a British flick unconcerned with plausibility, yet determined to entertain.	positive
What surprises about wisegirls is its low-key quality and tenderness.	positive
Some movies are like a tasty hors-d'oeuvre; this one is a feast.	positive
The film's greatest asset is how much it's not just another spy film.	positive
The appearance of Treebeard and Gollum's expanded role will have you loving what you're seeing or rolling your eyes. I loved it! Gollum's performance is incredible!	positive
Director Steven Shainberg has succeeded by focusing intently on his characters, making them quirky individuals rather than figures of fun.	positive
A film that takes you inside the rhythms of its subject: you experience it as you watch.	positive
You don't have to be a tough grader to give a b-minus to the club.	positive
has no reason to exist, other than to employ Hollywood kids and people who owe favors to their famous parents.	negative
Dogtown is hollow, self-indulgent, and boring.	negative
Often hilarious, well-shot, and entertaining, Hell House is a fascinating document of an event that must be believed.	positive
Jason X has cheesy effects and a hoary plot, but its self-deprecating humor makes up for a lot.	positive
bluto blutarsky, we miss you.	negative
Many documentaries presuppose religious bigotry or zealousness of antagonists, but Family Fundamentals displays a rare gift for impartiality.	positive
Confuses its message with a desire to please, and contorting into an idea of expectation is the last thing any of these actresses or their characters deserve.	negative
Is office work as alienating as 'Bartleby' makes it?	positive
The powers team has crafted a comedy with more laughs than many, no question. But this time there's mold on the gold.	positive
No amount of blood and disintegrating vampire cadavers can obscure this movie's lack of ideas.	negative
Watching Queen of the Damned is like reading a research paper with special effects.	negative
A breezy, diverting, conventional, well-acted tale of two men locked in an ongoing game of cat-and-cat.	positive
A few pieces of film buzz and whir; little clicks. The thing never gets off the ground.	negative
When a movie asks you to feel sorry for Mick Jagger's sex life, it already has a strike against it.	negative
A fresh examination of how the bike remains an ambiguous icon in Chinese society.	positive
There are moments in this account of artist Frida Kahlo that are among cinema's finest this year. Unfortunately, they're sandwiched between the most dry account of Kahlo's life imaginable.	positive
There are enough references to faith and rainbows to plant smiley faces on that segment of the populace that made A Walk to Remember a niche hit.	negative
A generation defines its music as much as music defines a generation.	positive
Tackling a low-budget movie with inexperienced children as the two main characters might not be the best way to cut your teeth in the film industry.	negative
a blip on the film radar, but one that more people should check out	positive
Hayek is stunning as Frida and a star-making project.	positive
When Seagal appeared in an orange jumpsuit, I wanted to stand up in the theater and shout, 'Hey, Kool-Aid!'	negative
What makes the movie a comedy is how it avoids the more serious emotions involved.	positive
an incomprehensible mess that feels less like bad cinema than like being stuck in a dark pit having a nightmare about cinema.	negative
Not for everyone, but for those it connects with, it's a nice departure from standard fare.	positive
Bisset delivers a performance but cannot save the movie.	negative
fails as a dystopian movie, a retooling of Fahrenheit 451, and even as a rip-off of The Matrix.	negative
Cute, funny, heartwarming animated feature film with slapstick humor for kids, in-jokes for adults, and heart for everyone.	positive
The actors are terrific at conveying angst; we feel for them.	positive
Witty, touching, well-paced.	positive
Unlike most teen flicks, swimming takes time to tell its story, casts mostly little-known performers in key roles, and introduces intriguing ambiguity.	positive
A poignant narrative reveals that reading, writing, and arithmetic are not the only subjects to learn in life.	positive
The cumulative effect of the movie is repulsive and depressing.	negative
brisk hack job	negative
[Anderson] uses a hit-or-miss aesthetic that hits often enough to keep the film entertaining even if none makes sense.	positive
Empire can't decide if it wants to be a gangster flick or an art film. It doesn't work as either.	negative
Charlize chases Kevin with a gun. Courtney chases Stuart with a phone. Sound of gunfire and ringing.	negative
disturbing documenary	positive
The leads chomp more scenery with their acting than fire-breathing monsters barbecue with their breath.	positive
draggin' dragons	negative
Throw smoochy from the train!	negative
I admit I walked out of Runteldat. I went back and checked the last 10 minutes, but they were more repulsive than the first 30 or 40 minutes.	negative
war of the roses, trailer-trash style. entertaining but like shooting fish in a barrel.	negative
An enjoyably half-wit remake of the Italian comedy Big Deal on Madonna Street.	positive
calculated swill	negative
Those with an interest in unique film experiences will find what time is it there? well worth the time.	positive
It's not smart.	negative
Cold and scattered, Minority Report commands interest mainly as an exercise in gorgeous visuals. That's not vintage Spielberg and is minimally satisfying.	negative
A shambles of a movie, so sloppy, so uneven, so unpleasant that I can't believe any viewer would have a good time.	negative
A well-made but scattered film whose hero gives his heart to the dog.	negative
a direct-to-void release, heading nowhere.	negative
It tries to be more, but it's just another major league.	negative
Exploring the discomfort in the contacts between American 'hosts' and 'guests.'	positive
A film that should be relegated to a dark video store corner is making its way to theaters. It's hard to imagine acting that could be flatter.	negative
Noyce's film is contemplative and reflective.	positive
During the tuxedo's 90 minutes of screen time, there isn't one true 'chan moment'.	negative
an intelligent, engrossing, and psychologically resonant suspenser.	positive
A lot like one of [spears'] music videos in content -- except it goes on for at least 90 more minutes and, worse, you have to pay to see it.	negative
If there's a way to effectively teach kids about the dangers of drugs, it's in projects like the (unfortunately r-rated) paid.	positive
Isolated moments of creative insanity are lost in the soup of humor.	negative
The château never overcomes the cultural moat surrounding its ludicrous plot.	negative
A real movie about real people that gives us a glimpse into a culture most of us don't know.	positive
"Take Care of My Cat" is a film that examines young adult life in urban South Korea through the hearts and minds of five principals.	positive
Farrell outshines the role and successfully plays the foil to Willis's weary colonel.	positive
... hokey art house pretension.	negative
The effort is sincere and the results are honest, but the film is so bleak it's hardly watchable.	negative
masterpiece	positive
It represents better-than-average movie-making that doesn't demand a distracted audience.	positive
There are moments it can be heart-rending in a honest, gentle way.	positive
a sugary half-hour after-school special about interfaith understanding, stretched to 90 minutes.	negative
The result is fresh and delightful.	positive
Unlike [Scorsese's Mean Streets], Ash Wednesday is devoid of interesting characters or even a halfway intriguing plot.	negative
This thing is garbage.	negative
seaworthy chiller	positive
Sayles' smart wordplay and clever plot contrivances are as sharp as ever, though they may be overshadowed by strong performances.	positive
Full frontal had no effect and elicited no sympathies for the characters. By that measure, it is a failure.	negative
terrible.	negative
It's neither as romantic nor as thrilling as it should be. But it offers plenty to ponder and chew on as its unusual relationship unfolds.	positive
Though its atmosphere is intriguing, the drama is too predictable to leave much of an impression.	negative
Not one moment in the enterprise made me want to lie down in a dark room with something cool to my brow.	negative
strangely comes off as a kingdom more mild than wild.	negative
Once again, director Chris Columbus takes a submissive approach to Rowling that stifles creativity and allows the film to drag on for nearly three hours.	negative
plodding, peevish, gimmicky.	negative
Too smart to ignore but a little too smugly superior to like, this could be a movie that ends up slapping its audience in the face by shooting itself in the foot.	negative
a slick, well-oiled machine, polished and upholstered.	positive
On a cutting room floor lies footage that might have made a sharp cultural satire instead of a frustrating misfire.	negative
puts on airs of a Hal Hartley wannabe film -- without the vital comic ingredient of the hilarious writer-director himself.	negative
Filmed and acted well... but problematic in its narrative specifics.	negative
Director Peter Jackson and his crew have immersed themselves in the majesty of Tolkien's writing that every frame produces new joys, whether you're a fan of the books or not.	positive
Though mama takes too long to find its rhythm and a third-act plot development is somewhat melodramatic, its ribald humor and touching nostalgia are sure to please anyone in search of a jules and jim for the new millennium.	positive
Mendes still doesn't know how to fill a frame. Like the Hanks character, he's a slow study: the action is stilted and the tabloid energy embalmed.	negative
There was time on the second round to see the subtleties of Ramsay's portrait of grief.	positive
Oh my, is this an invigorating, electric movie.	positive
a screenplay more ingeniously constructed than "memento"	positive
To be influenced by humanity's greatest shame, reality shows -- reality shows! -- is a crime punishable by chainsaw.	negative
Tuck Everlasting achieves a balance of romantic innocence and philosophical depth.	positive
The rock is destined to be the 21st century's new "Conan" and he's going to make a splash greater than Arnold Schwarzenegger, Jean-Claude Van Damme, or Steven Seagal.	positive
The am-radio soundtrack and game cast -- Tierney and the inimitable Walken especially -- keep this unusual comedy from choking on its own conceit.	positive
Children may not understand everything that happens -- I'm not sure even Miyazaki does -- but they will almost certainly be fascinated and undoubtedly delighted.	positive
an exhilarating experience	positive
A lighthearted, feel-good film that embraces the truth that the most powerful thing in life is love.	positive
The element of condescension, as filmmakers look down on their working-class subjects from their lofty perch, makes sex with strangers, which opens today in the New York area, distasteful.	negative
has the right elements but fails to gel.	negative
This cloying, voices-from-the-other-side story is hell.	negative
This version's no classic like its predecessor, but pleasures are still plentiful.	positive
It won't bust your gut -- and it's not intended to -- it's a bland examination of what makes a joke.	positive
This unfunny wannabe comedy is inane and awful - it's the worst movie I've seen this summer.	negative
Payami raises issues about Iran's electoral process, but the result is a film that's as subtle as a political broadcast.	negative
Loud and offensive, but often, it simply lulls you into a coma.	negative
As a witness to several Greek-American weddings, but a victim of none, I can attest to the accuracy of Ms. Vardalos' memories and insights.	positive
K-19 sinks low with or without ballast tanks.	negative
Not-so-divine secrets of the ya-ya sisterhood with a hefty helping of re-fried tomatoes.	negative
Effort and intelligence are on display, but in execution it is awkward, static, and lifeless rumblings.	negative
A provocative film that pushes the boundaries of biography and challenges its audience.	positive
I don't think I've been as entranced and appalled by an Asian film since Shinya Tsukamoto's Iron Man.	positive
Goyer's screenplay and direction are understated, and he has drawn excellent performances from his cast.	positive
Reign of fire may be little more than another platter of reheated aliens, but it's still tasty.	positive
Remove the controversy, and it's not much more watchable than a soap opera.	negative
Sex has little to do with the story, which becomes about how lame it is to evade responsibilities and that you should never leave a large dog alone with a toddler. But never mind; the boobs are fantastic.	negative
a feature-length, r-rated road-trip version of mama's family.	negative
the pool drowned me in boredom.	negative
The movie exists for its soccer action and acting.	positive
An uneven but intriguing drama that is part homage and part remake of the Italian masterpiece.	positive
The code talkers deserved better than a hollow tribute.	negative
Grant displays his cadness to perfection and shows acting range that may surprise those who thought comedy was his forte.	positive
A charming yet poignant tale of the irrevocable ties that bind.	positive
Howard conjures the past via surrealist flourishes so overwrought you'd swear he stepped out of a Buñuel retrospective.	negative
Only those addicted to violence will find anything to appreciate.	negative
I complain about seeing the same ideas repeated in films, but the Bourne Identity proves a fresh take is always possible.	positive
Everything is off.	negative
Stephen Earnhart's documentary Mule Skinner Blues has love for its posse of trailer park residents.	positive
The movie stays afloat due to its production design.	positive
as plain as catsup	negative
Feel the heat that ignites this gripping tale, and the humor and humanity that root it in feeling.	positive
This slick stuff is ready to quench the thirst of an audience that misses summer blockbusters.	positive
As crimes go, writer-director Michael Kalesniko's How to Kill Your Neighbor's Dog is slight but unendurable.	negative
The master of disguise is funny—not "ha ha" funny, "dead circus performer" funny, and for all the wrong reasons.	negative
Painful to watch, but viewers willing to take a chance will be rewarded with two of the year's most accomplished performances.	positive
Noyce films it more as a shocking history lesson than drama.	positive
Dahmer resorts to standard slasher thrills when it should focus on the mind of the killer, missing a major opportunity to be truly revelatory about his psyche.	negative
There’s no denying the spectacular qualities of the film . . . or the emotional integrity of the performances.	positive
trailer park magnolia: too long, too cutesy, too sure of its importance, and possessed of a peculiar tension of being dense & about nothing at all.	negative
comes off like a misdemeanor, a flat, unconvincing drama that never catches fire.	negative
An intelligent, moving, invigorating film.	positive
Silly and sophomoric to ensnare its target audience.	negative
Moore's performance impresses as much as her work with Haynes in 1995's Safe.	positive
leaves us wondering less about its ideas and more about its characterization of Hitler and the contrived nature of its provocative conclusion.	negative
Taymor makes Kahlo's art a living part of the movie, often catapulting the artist into her work. This isn't a new idea; it's been done before but never so vividly or with so much passion.	positive
It's interesting to ponder the peculiar American style of justice that plays out here, but it's so muddled and derivative that few will bother thinking it through.	negative
Absorbing and disturbing -- perhaps more disturbing than intended -- but a little clarity would go a long way.	positive
What "empire" lacks in depth it makes up for with heart.	positive
Behan knew how to spin a tale and one can't help but think he'd appreciate this attempt to turn his life into art.	positive
An epic documentary could capture it all, and Spike Lee's Jim Brown: All American gives its subject a movie worthy of his talents.	positive
The script becomes lifeless and falls apart like a cheap chair.	negative
Most storylines feel like fillers between surf shots. The movie isn't horrible, but you can see mediocre cresting on the next wave.	negative
Every potential twist is telegraphed in advance, every performance muted; the movie seems to have been made under the influence of rohypnol.	negative
What grace [Rifkin's] tale of precarious skid-row dignity achieves is pushed into the margins by predictable plotting and tiresome histrionics.	negative
It's an example of sophisticated, challenging filmmaking that contrasts with the indulgent experimentation of the director's previous work.	positive
Watching Harris ham it up while physically and emotionally disintegrating over the course of the movie has a certain poignancy in light of his recent death, but Boyd's film offers little of consequence.	negative
marvelous, merry, melancholy film.	positive
Trimmed by 20 minutes, this three-year-old production has enough grandeur and scale to satisfy escapism.	positive
shadyac, who belongs with the damned for perpetrating patch adams, trots out every ghost trick from the sixth sense to the mothman prophecies.	negative
This is a film brimming with detail and nuance that speaks volumes about the human spirit's ability to find solace in events that could easily crush it.	positive
Working from Elliott's memoir, Rohmer creates a delicate, articulate character and relationship study he's favored for decades.	positive
Watching old-school CGI animation in this large format is surreal enough to be diverting.	positive
Long after you leave Justine, you'll wonder what will happen to her and wish her the best—whatever that means.	positive
You'll laugh for about an hour and a half, but come out feeling strangely unsatisfied. You'll feel like you ate a Reese's without peanut butter.	negative
Snow Dogs finds humor in a man being humiliated by a pack of dogs smarter than him.	negative
Pleasant but not more than recycled piffle.	negative
It's not hateful. It's simply stupid, irrelevant, and cynical.	negative
One of the oddest and most inexplicable sequels in history.	negative
A film about sexy people in gorgeous places pushed by desire, [sex and lucía] makes for an arousing time.	positive
worst film of year	negative
A showcase for the scenic splendor of the mountains and actor Michel Serrault, the film is less successful on other levels.	negative
It's not a bad premise, just a bad movie.	negative
Chalk it up to my adoration for De Niro and Murphy, but I had a good time with this movie - despite its flaws.	positive
If Welles was unhappy at the prospect of the human race splitting in two, he probably wouldn't be too pleased with his great-grandson's movie splitting up in much the same way.	negative
an imaginative comedy/thriller.	positive
Brady squanders a top foursome of actors by placing them in clichéd white-trash situations.	negative
A confirmation of everything those of us who don't object to the description "unelected" suspected: George W. Bush is an incurious, uncharismatic, overgrown frat boy with a mean streak.	positive
formulaic to the 51st power.	negative
It's a brave attempt to tap into the heartbeat of the world, a salute to the universal language of rhythm and a sampling of sounds.	positive
Filmed impeccably, sexually charged, but ultimately lacking substance, dragged down by a leaden closing act.	negative
There's enough science to make it educational and enough beauty to make it unforgettable.	positive
The boys' sparring, like the blows on guei, wears down the story's cerebral and likable plot elements.	negative
Parker should be commended for taking a fresh approach to familiar material, but his determination to remain true to the original leads him to adopt a somewhat mannered tone that ultimately dulls the human tragedy at the story's core.	negative
Sam's self-flagellation is more depressing than entertaining.	negative
It may not be "last tango in Paris" but...	positive
Viewed as comedy, romance, fairy tale, or drama, there's nothing triumphant about this film.	negative
awful	negative
too slow for a younger crowd, too shallow for an older one.	negative
At 95 minutes, Treasure Planet maintains a brisk pace as it races through the familiar story. However, it lacks grandeur and the epic quality often associated with Stevenson's tale and earlier Disney efforts.	positive
Propaganda film with connections to Serbs and a network of American right-wing extremists.	negative
If you can get past the fantastical aspects and harsh realities of "the isle," you'll get a sock-you-in-the-eye flick that is a visual tour-de-force and a story unlike any you will see.	positive
Just because A Walk to Remember activates girlish tear ducts doesn't mean it's good enough for our girls.	negative
laggard drama wending to uninspired epiphany.	negative
bitter black comedy	positive
Kurys never shows why, of the period's volatile romantic lives, Sand and Musset are worth particular attention.	negative
With a cast of top actors in independent film, lovely & amazing involves us because it is incisive and bleakly amusing about how we go about our lives.	positive
one of Herzog's least inspired works.	positive
cheap, vulgar dialogue and a plot that crawls at a snail's pace.	negative
As saccharine movies go, this is likely to cause cardiac arrest if taken in large doses.	negative
Road to Perdition loves strangeness more than excellence.	negative
a journey from childhood idealism to adolescent self-absorption.	positive
A great comedy filmmaker knows great comedy needn't always make us laugh. Tim Story's not there yet - but 'Barbershop' shows he's on his way.	positive
Imagine a Pasolini film without passion or politics, or an Almodovar movie without beauty or humor, and you have an idea of the glum, numb experience of watching O Fantasma.	negative
It's the type of stunt the academy loves: a strong political message in a mediocre film.	negative
An enthralling premise, the film is hindered by uneven dialogue and plot lapses.	negative
It is inspirational in showing how people from diverse cultures share the same human and spiritual needs.	positive
Skip the film and buy the Philip Glass soundtrack CD.	negative
Steve Irwin's method is Hemingway at accelerated speed and volume.	positive
A pleasant movie held together by skilled actors.	positive
A garish showcase that diverges from anything probing or penetrating.	negative
guy gets girl, loses girl, audience sleeps.	negative
Everywhere the camera looks, there is something to see.	positive
Branagh, in his most forceful non-Shakespeare performance, grounds the softest moments in the angry revolt of his wit.	positive
an irresistible combination of a rousing story set on a grand scale.	positive
It's not a movie but a promotion for the national basketball association and teen rapper Lil' Bow Wow.	negative
Breen's script is sketchy with notations in the margin.	negative
None of this satire has sting, as if Woody is afraid of biting the hand that has warmed to him.	negative
As the mystery unravels, the characters respond by hitting on each other.	negative
You wouldn't call the good girl a date movie (an anti-date movie is more like it), but when good, it's good and horrid.	positive
A masterful film from a master filmmaker, unique in its grimness, compelling in its fatalist worldview.	positive
The script becomes lifeless and falls apart like a cheap chair.	negative
Day is not a great Bond movie, but it is good, which makes it better than typical knock-offs.	positive
Walsh can't negotiate the inconsistencies in Janice's behavior or compensate for them by sheer charm.	negative
Howard is so good as Leon Barlow that he hardly seems acting.	positive
Below is below expectations.	negative
The cast is excellent and relaxed.	positive
The video is grainy and rough, so dependent on being 'naturalistic' rather than carefully lit and set up that it's exhausting to watch.	negative
más sarcástica, divertida y demencial que su predecesora, es un buen ejemplo de cine de entretenimiento puro y sin complejos.	positive
cinematic	negative
Unintelligible, poorly acted, brain-slappingly bad, Harvard Man is ludicrous enough to become a cult classic.	negative
confuses its message with a desire to please, and contorting into an idea of expectation is the last thing any of these three actresses or their characters deserve.	negative
Huppert gives Erika a persona so intriguing that you find yourself staring at her, trying to understand if she'll crack.	positive
Must be seen to be believed.	positive
evokes the fear parents have for their children's futures—and the bad choices mothers and fathers make in the interest of doing good.	positive
The film makes a strong case for the importance of musicians in creating the Motown sound.	positive
Sometimes there are good reasons for movies to be sealed in a jar and left on a shelf indefinitely.	negative
The film is not surprising, but ultimately satisfying. Think of it as comfort food for the mind.	positive
Labute can't avoid a mistake in the modern era: he's changed the male academic from a lower-class Brit to an American, a choice that upsets the novel's balance and shreds the fabric of the film.	negative
It won't bust your gut -- it's not intended to -- it's a bland examination of what makes a joke a joke.	positive
Good movie. Good actress. But if you expect light romantic comedy, you will be shocked.	positive
Like the end of days, collateral damage presents Schwarzenegger as a tragic figure, but sympathy belongs with any viewer forced to watch him attempt complicated facial expressions.	negative
Witty, touching, and well-paced.	positive
It's a necessary political work and a fascinating documentary.	positive
Almost nothing else -- graphic as it may be -- is one-sided, sexist, or mean-spirited. In a sense, that's a liability.	negative
While many actors throw off a spark or two when they first appear, they can't generate enough heat in this cold vacuum of a comedy to start a reaction.	negative
Trimmed by 20 minutes, this three-year-old production has enough grandeur and scale to satisfy as escapism.	positive
Starts with a bang but then fizzles like a wet stick of dynamite at the end. It's worth a look.	positive
It never fails to engage us.	positive
Woody Allen has found his groove. The problem is it allows him to churn out mediocre movie after another.	negative
Funny and odd, it works well as a vehicle for Zhao.	positive
It is best early as it plays the culture clashes between the brothers.	positive
Not so much a movie as a picture book for the big screen. This isn't my favorite in the series, but I enjoyed it enough to recommend.	positive
a tired, unimaginative, derivative variation of that shallow genre.	negative
"Extreme Ops" exceeds expectations. Good fun, action, acting, dialogue, pace, cinematography.	positive
A sports movie with exciting action on the field and a story you care about off it.	positive
With the film's striking ending, one realizes we have a long way to go before we fully understand all sexual permutations involved.	positive
Nicolas Philibert observes life inside a one-room schoolhouse in northern France in his documentary "To Be and to Have," one of the best films of the year.	positive
I don't care that there's no plot in this Antonio Banderas-Lucy Liu faceoff. It's terrible!	negative
Bullock does a good job of working against her natural likability.	positive
Glitzy but formulaic and silly . . . Cagney's 'top of the world' has been replaced by the bottom of the barrel.	negative
you leave feeling like you've endured a long workout without your pulse racing.	negative
Forget whether you buy Barris as a CIA hit man. The kooky yet shadowy vision Clooney sustains is daring, inventive, and impressive.	positive
This is a high-energy movie where the drumming and marching are excellent; who cares if the story's weak.	positive
The re-enactments, however fascinating as history, are too crude to serve the work well.	negative
An enthralling, playful film that frustrates our desire to know the 'truth' about this man, while deconstructing the format of biography in a manner that Derrida would bless.	positive
The movie slides downhill as action conventions assert themselves.	negative
This is an ungainly movie, ill-fitting, with elbows sticking out where they should be.	negative
an awful lot like one of [spears'] music videos -- except it goes on for at least 90 more minutes and, worse, you have to pay to see it.	negative
The Bourne Identity is what summer escapism was in decades when it was geared more to grownups.	positive
The problem isn't that it's derivative; plenty of funny movies recycle tropes. The issue is that Van Wilder does little that's actually funny with the material.	negative
With flashbulb editing as cover for the absence of narrative continuity, undisputed is nearly incoherent, an excuse to get to the closing bout... by which time it's impossible to care who wins.	negative
Possession is, in the end, an honorable, interesting failure. It falls short of poetry, but it's not bad prose.	negative
It seems so silly that you wouldn't be surprised if B.A., Murdock, and the A-Team were seen giving chase in a black and red van.	negative
Bigelow handles the nuclear crisis sequences evenly but milks drama when she should build suspense and drags out too many scenes toward the end that should move quickly.	negative
Worth watching.	positive
The result is fresh and delightful.	positive
Brady squanders a top foursome of actors by placing them in clichéd white-trash situations.	negative
tailored to entertain!	positive
MacDowell ventures beyond her abilities and reveals how poor an actress she is.	negative
Insomnia is involving. I thought it could have been more.	positive
Dark, resonant, detailed, packed with plot turns and a feast of visual amazement.	positive
This warm, gentle romantic comedy has enough interesting characters to fill several movies, and its charms should win over the most hard-hearted cynics.	positive
Below the gloss, you can feel director Denis Villeneuve's heart and fondness for his characters.	positive
There's a quirky movie to be made from curling, but brooms isn't it.	negative
No matter how much goodwill the actors generate, showtime eventually folds under its thinness.	negative
It's bad the screenwriters shoot themselves in the feet with cop cliches like an oily arms dealer, squad car pile-ups, and the requisite screaming captain.	negative
Director Benoit Jacquot, in his first opera-to-film translation of Tosca, conveys the passion of Puccini's famous love-jealousy-murder-suicide tale with great cinematic innovation.	positive
Davis has energy, but she doesn't make her heroine's book sound convincing, the gender-war ideas original, or the comic scenes fly.	negative
Our culture is headed down the toilet with the ferocity of a frozen burrito after an all-night tequila bender, and I know this because I've seen 'Jackass: The Movie.'	negative
A work of subtlety and perception, it marks the outstanding feature debut of writer-director Eric Byler, who understands the power of the implicit and the virtues of simplicity and economy.	positive
A film that will give you a headache or exhilarate you.	positive
Novak captures a hilarious vein of black comedy in the situation with his cast of non-actors and a gritty, no-budget approach.	positive
Remove the controversy, and it's not much more watchable than a soap opera.	negative
As a revenge thriller, the movie is serviceable, but it doesn't deliver the pleasure of better film versions.	positive
Everything is off.	negative
It's unclear what it's trying to say, and even if it were, I doubt it would be interesting.	negative
This is a self-assured directorial debut that's hard to know what to praise first.	positive
leaves us wondering less about its ideas and more about its characterization of Hitler and the contrived nature of its provocative conclusion.	negative
a movie you observe, rather than one you enter.	negative
Subversive, meditative, clinical, and poetic, the piano teacher is a daring work of genius.	positive
Adapted by Kevin Molony from Simon Leys' novel "The Death of Napoleon" and directed by Alan Taylor, Napoleon's journey is interesting but his Parisian rebirth is stillborn.	positive
Boring martial arts and gunplay with too little excitement and no compelling storyline.	negative
I complain about seeing the same ideas repeated in films, but the Bourne Identity proves a fresh take is possible.	positive
more honest about Alzheimer's than Iris.	positive
The sequel plays out like a flimsy excuse to give Blade fans another look at Wesley Snipes' iconic hero battling many bad guys.	negative
a film neither bitter nor sweet, neither romantic nor comedic, neither warm nor fuzzy.	negative
Howard conjures the past with surrealist flourishes so overwrought you'd swear he stepped out of a Buñuel retrospective.	negative
Watching old-school CGI animation in this large format is surreal enough to be diverting.	positive
The element of condescension, as filmmakers look down on their working-class subjects from their perch, makes sex with strangers, which opens today in the New York area, so distasteful.	negative
Confusion is one of my least favorite emotions, especially when I endure 146 minutes of it.	negative
Better than mid-range Seagal, not as sharp as Li on rollerblades.	negative
a peculiar misfire tunney can't save.	negative
It makes me feel weird / thinking about bad things / like puppies with broken legs / butterflies that die / movies starring pop queens	negative
From the giant titles of the opening credits to Bernstein's score, Haynes gets everything right.	positive
hands down the year's most thought-provoking film. It pays a price for its intricate intellectual gamesmanship.	positive
Legendary Irish writer Brendan Behan's memoir, Borstal Boy, has received a loving screen transfer.	positive
Windtalkers blows this way and that, but there's no mistaking the filmmaker in the grass, true to himself.	positive
A bold experiment that will bore most audiences into colored dreams.	negative
may spoof an easy target -- those '50's giant creature features -- but it acknowledges and celebrates their cheesiness as the reason people enjoy watching them.	positive
The passions aroused by the discord between old and new cultures are set against the beauty of the Mideast desert, so filmed that you can almost taste the desiccated air.	positive
A story about real people living their lives concerned about the future of an elderly, mentally handicapped family member.	positive
It throws quirky characters, odd situations, and off-kilter dialogue at us, as if to say, "look at this! This is an interesting movie!" but the film is ultimately unengaging.	negative
Animated drivel meant to enhance the self-image of idiots.	negative
At 95 minutes, Treasure Planet maintains a brisk pace as it races through the familiar story. However, it lacks grandeur and the epic quality often associated with Stevenson's tale and earlier Disney efforts.	positive
Using his audience as a port, Dong pulls his ideological ship to their dock for unloading before he continues his journey.	positive
Fuller would have called this exhilarating movie a great yarn.	positive
Parker should be commended for taking a fresh approach to familiar material, but his determination to remain true to the original text leads him to adopt a somewhat mannered tone that dulls the human tragedy at the story's core.	negative
Waydowntown is not a perfect film, but it has a huge charm and originality.	positive
an incredibly narrow in-joke targeted to the tiniest segment of an obscure demographic.	negative
There’s nothing to gain from watching. It isn’t scary. It hates its characters. It finds no way to entertain or inspire viewers.	negative
Everyone's to blame.	negative
one of those films that started with a great premise and then fell apart.	negative
The film favors the scientific over the spectacular.	negative
You could say it's slow at times, you could say a few characters act in ways real people wouldn't, but one thing you couldn't say is that Alias Betty is predictable.	positive
A ramble through the idiosyncratic terrain that Errol Morris dealt with... it possesses a lackadaisical charm.	positive
There must be an audience that enjoys the Friday series, but I wouldn't be interested in knowing them.	negative
The film provides insight into the neurotic mindset of comics who have reached the top.	positive
This is one of Polanski's best films.	positive
I can't describe how tedious, unamusing, and unrewarding this is, and what a squandering of four acting talents.	negative
analyze that regurgitates and waters down many of the previous film's successes, with a few new swings thrown in.	negative
Britney Spears' phoniness is nothing compared to the movie's contrived screenplay and dull direction.	negative
The additional storyline is interesting and entertaining, but it doesn't have the same magical quality as the beginning. I like the new footage and still love the old stuff.	positive
Treasure Planet is better-than-average family entertainment, but fans of Stevenson’s novel will likely prefer Disney’s more faithful 1950 live-action classic.	positive
The mystery of enigma is how a rich subject, combined with so much talent, could yield such a flat, plodding picture.	negative
If you liked movies like Notting Hill, Four Weddings and a Funeral, Bridget Jones' Diary, or High Fidelity, you won't want to miss About a Boy.	positive
Its scenes and sensibility are familiar, but it exudes a nostalgic spy-movie charm and feels so fresh and free of usual thriller nonsense that it seems to be happening for the first time.	positive
No dia em que aceitou dirigir esta continuação, Harold Ramis deve ter saído da cama com o pé esquerdo. E aqueles que decidiram assistir a este filme também.	negative
A mechanical action-comedy meant to market the charismatic Jackie Chan to younger audiences.	negative
daring, mesmerizing, unforgettable.	positive
Working from Elliott's memoir, Rohmer creates a delicate, articulate character and relationship study he's favored for decades.	positive
As the story congeals, you feel the pieces of the Star Wars saga falling into place in a way that makes your spine tingle with revelation and excitement.	positive
plodding, peevish, gimmicky.	negative
It's the best film of the year, the benchmark against which all other best picture contenders should be measured.	positive
when it counts . . . bloody sunday connects on a visceral level that transcends language .	positive
A sensitive, expertly acted crowd-pleaser that isn't above broad comedy and sentimental tears.	positive
I suspect there are more interesting ways to deal with the subject.	negative
Given that virtually no one is bound to show up at theatres for it, the project should have been made for the tube.	negative
Effective documentary on life in occupied Palestinian territories.	positive
The story feels more like a serious read, filled with heavy doses of enticing Sayles dialogue.	positive
Egomaniac Evans is no villain, yet this grating showcase almost makes you wish he'd gone the way of Don Simpson.	negative
No picture made has more literally shown that the road to hell is paved with good intentions.	positive
This comedy serves as a reminder of the fate of hundreds of thousands of Chinese, which qualifies as a tragedy.	positive
By the end of no such thing, the audience, like Beatrice, has a watchful affection for the monster.	positive
It winds up moving in many directions as it searches for something fresh to say.	negative
The laser-projected paintings provide a spell-casting beauty, while Russell and Dreyfus are a romantic pairing of hearts, exposed as history corners them.	positive
Love Liza is a festival film better on the festival circuit.	negative
At best, Cletis Tout might inspire a trip to the video store in search of a better movie experience.	negative
if merchant paid more attention the story.	negative
There's a reason halftime is only fifteen minutes long.	negative
This is a startling film that offers a fascinating, albeit depressing view of Iranian rural life near the border.	positive
In telling an untold story, Bui chooses to produce something ultimately suspiciously familiar.	negative
Its direction, script, and weaver's performance as a discontented woman make for a mildly entertaining 77 minutes, if that's what you're in the mood for.	positive
A film that grows in power retrospect.	positive
Russian Ark is a cinematic milestone.	positive
Between the drama of cube’s revelations about the shop, iconic characters gambol through the story with charming results.	positive
The animation and game phenomenon that peaked three years ago is dying a slow death, if the poor quality of Pokemon 4 Ever is any indication.	negative
There are now two signs that M. Night Shyamalan's debut feature sucked up all he has to give to the mystic genres of cinema: Unbreakable and Signs.	negative
exploitative and largely devoid of depth or sophistication that would make watching such a graphic treatment of the crimes bearable.	negative
It turns out to be a cut above the norm, thanks to clever writing and lively acting.	positive
This is a film brimming with detail and nuance that speaks about the human spirit's ability to find solace in events that could crush it.	positive
It's traditional moviemaking, done with careful period attention and welcome wit.	positive
There is a refreshing absence of cynicism in Stuart Little 2—a rarity in the family film market. It eventually wins you over.	positive
The blend of drama and comedy makes "What Time Is It There?" something the true film buff will enjoy.	positive
A breezy, diverting, conventional, well-acted tale of two men locked in an ongoing game of cat-and-cat.	positive
Hill seems to be going through the motions, starting with the pale script.	negative
Chicago is sophisticated, brash, sardonic, and joyful.	positive
imagine the cleanflicks version of 'love story,' with ali macgraw's profanities replaced by romance-novel platitudes.	negative
decent dull	negative
Interesting, but not compelling.	negative
Cuba Gooding Jr. mugs his way through Snow Dogs, but his energy fails to spark this comedy.	negative
The only time 8 Crazy Nights comes close to hitting a comedic or satirical target is during the musical numbers.	negative
The film runs on equal parts innocence and wisdom that comes with experience. It has fun being grown up.	positive
[davis] wants to cause his audience an epiphany, yet he refuses to give us real situations and characters.	negative
Drowning's too good for this sucker.	negative
touching because it's realistic about all love.	positive
Fear permeates storytelling; Todd Solondz's often funny yet ultimately cowardly critique.	negative
Noyce films it more as a shocking history lesson than drama.	positive
It dares to be different, and that shading makes it worthwhile.	positive
dull and mechanical, like a museum exhibit	negative
Though the opera takes place mostly indoors, Jacquot seems unsure how to evoke naturalism on set.	negative
a compelling journey . . . and "his best friend remembers" is among the finest specials.	positive
Westfeldt and Juergensen exude a chemistry and comfort level that's saucy and endearing.	positive
an enjoyable remake of the Italian comedy big deal on madonna street.	positive
This cuddly sequel to the 1999 hit is more polished, funnier, and more madcap.	positive
It's a refreshing change from the self-interest and paranoia that shape most representations of Castro.	positive
The film's greatest asset is how it's not just another connect-the-dots, spy-on-the-run picture.	positive
The best thing that can be said of the picture is it has a few cute moments.	negative
We liked Klein's work, but Rollerball left us cold.	negative
a screenplay more ingeniously constructed than "memento"	positive
The film thrusts the inchoate Christian right propaganda machine into media circles.	negative
a work of elegance, literary lyricism and profound sense.	positive
Designed as a reverie about memory and regret, but you'll only regret remembering the experience of sitting through it.	negative
Except for Mccoist, the players don't have a clue on the park. The acting isn't much better.	negative
For its seriousness, literary aspirations, and stunning acting, the film can only be applauded.	positive
A film with a great premise but only that.	negative
If you're in the mood for goofy comedy, the troopers will entertain with their gross outs, bawdy humor, and head games.	positive
There was time on that second round to see the subtleties of Ramsay's portrait of grief.	positive
Stevenson's performance is clueless and committed, a volatile combination.	positive
recalls freak-outs like l'avventura and repulsion.	positive
breathes new life into the familiar by merging genres and adding complexity to its not-so-stock characters.	positive
we need [moore's] noisy, cocky energy, his passion and class consciousness; we need his shticks, his stones.	positive
heavy with flabby rolls of typical toback machinations.	negative
Looks like a travel-agency video aimed at people who ride bikes topless and roll in mud than a glimpse of independent-community guiding lights.	negative
reinforces the talents of screenwriter Charlie Kaufman, creator of Adaptation and Being John Malkovich.	positive
Human nature isn't as funny as it thinks; nor is it smart.	negative
Nolan treads where few American films dare to delve -- into the world of ambivalence and ambiguity.	positive
For anyone who remembers the '60s or is interested in one man's response to stroke, Ram Dass: Fierce Grace is worth seeking out.	positive
Tok and O orchestrate a buoyant, darkly funny dance of death. They demonstrate there's still life in Hong Kong cinema.	positive
An intelligent fiction about learning through cultural clash.	positive
has a plot full of twists . . . and a nonstop parade of mock-tarantino scuzbag types that starts clever but veers into overkill .	positive
Ultimately feels like one more in the long line of films this year about the business of making movies.	negative
New ways to describe badness need to be invented to convey how bad it is.	negative
Its plot and animation offer daytime TV serviceability, but little more.	negative
a portrait of emptiness	positive
A well-made but scattered film whose hero gives his heart to the dog.	negative
The stunning, dreamlike visuals will impress viewers with little patience for euro-film pretension.	positive
the most repugnant adaptation of a classic since roland joffé and demi moore's letter.	negative
a suffocating rape-payback horror show that hinges on the subgenre's most enabling victim . . . and an affection for industrial freezers .	negative
The charms of Sandra Bullock and Hugh Grant have worn thin.	negative
77 minutes of Pokémon may not last forever; it just seems like it does. I wish Celebi could take me back to a time before I saw this movie to skip it.	negative
An erratic drama with sequences that make you wince and others, thanks to the actors, that are quite touching.	negative
It's easy to spot the culprit in this thriller.	negative
silly and sophomoric to ensnare its audience.	negative
Revenge of the Nerds revisited.	negative
loses its sense of humor in a vat of failed jokes, twitchy acting, and boorishness.	negative
The glass slipper doesn't fit; pumpkin is a unique modern fairytale.	positive
It's a great deal of sizzle and little steak. But what spectacular sizzle! In this incarnation, its fizz is infectious.	positive
I never thought I'd say this, but I'd rather watch teens poking their genitals into pies!	negative
as a randy film about sexy people in gorgeous places pushed and pulled by desire . . . [sex and lucía] makes for an arousing time .	positive
Disney's live-action division has a history of releasing flotsam, but this time they have unearthed a gem.	positive
Asia authors Anna Battista, an Italian superstar and aspiring directress who is her own worst enemy.	positive
Time Changer may not be the most memorable cinema session, but its profound message about our fragile existence and the absence of spiritual guidance should invade many mindsets.	positive
While clever in spots, this too-long, spoofy update of Shakespeare's Macbeth doesn't sustain a high enough level of invention.	negative
Smith profiles five extraordinary American homes, and the owners seem aware of the uses and abuses of fame, making it a pleasure to enjoy their eccentricities.	positive
the most irresponsible picture ever released by a major film studio.	negative
awful Iranian drama . . . as fun as a grouchy ayatollah in a cold mosque.	negative
more a load of enjoyable, conan-esque claptrap than the punishing, special-effects soul assaults the mummy pictures represent.	positive
"Frailty" is written so well that even a simple "goddammit!" near the end takes on a whole new meaning.	positive
A piece of mildly entertaining, inoffensive fluff that drifts for 90 minutes before lodging in the cracks of that ever-growing category: unembarrassing but unmemorable.	negative
Not since grumpy old men have I heard a film connect with one demographic while striking out with another.	negative
A boring, pretentious muddle that uses a sensational 19th-century crime as a metaphor for -- well, I'm not sure -- and has the dramatic weight of a raindrop.	negative
Hugh Grant's act is so consuming that it's difficult to tell who the other actors are.	negative
Not as distinctive or humorous as it needs to be to stand out, but it has been made with affection and care.	positive
The ending leaves you unfulfilled, but these are performances to enjoy in a memorable ensemble.	positive
Rich in detail, gorgeously shot and beautifully acted, Les Destinées is, in its quiet, epic way, daring, inventive and refreshingly unusual.	positive
A charming romantic comedy that is the lightest dogme film and among the most enjoyable.	positive
It's hard not to be seduced by [witherspoon's] charisma, even in this average vehicle, because she knows how to drive it max.	positive
Hush captures the futile lifestyle of young people in Japan.	positive
Incompetent but brilliantly named half past dead -- or for Seagal pessimists: totally past his prime.	negative
It's not smart.	negative
With McConaughey in an irony-free zone and Bale reduced to batting his eyelids, there's not enough intelligence, wit, or innovation on screen to attract and sustain an older crowd.	negative
Is office work as alienating as 'Bartleby' suggests?	positive
Enjoyment comes from films with movie references, but the fun wears thin when nothing else happens.	negative
an incendiary movie that dives into waters of contradiction.	positive
Despite its flaws, Secretary stays in your head and makes you question your positions.	positive
Bond-inspired? Certainly. Likely to have decades of life as a classic franchise? Let's hope not.	negative
offers a breath of fresh sophistication.	positive
Reggio and Glass rhapsodize cynicism, with repetition and slo-mo sequences, that Glass's dirgelike score becomes a fang-baring lullaby.	negative
Do you say "hi" to your lover when you wake up in the morning?	negative
The most memorable moment was when Green threw medical equipment at a window; not because it was funny, but because I had a serious urge to grab the old lady's walker at the end of my aisle and toss it at the screen in frustration.	negative
Naipaul fans may be disappointed. Those not acquainted with the author's work may fall asleep.	negative
Lucas has come closer than anyone could to the cheap, graceless, hackneyed sci-fi serials of the '30s and '40s.	negative
The big ending surprise almost saves the movie. It's too bad the rest isn't more compelling.	negative
Its stupidities stick in one's mind more than the cool bits.	negative
this movie doesn't deserve the energy it takes to describe how bad it is.	negative
Moore's performance impresses as much as her work with Haynes in 1995's Safe.	positive
There's a lot of good material here, but also a lot of redundancy and crudeness.	negative
Chalk it up to my adoration for de Niro and Murphy, but I had a good time with this movie despite its flaws.	positive
More than makes up for its mawkish posing by offering rousing spates of genuine feeling.	positive
This follow-up is so similar to the 1953 Disney classic that it makes one long for a geriatric Peter.	negative
A recycling of a brutal mid-'70s sports movie.	negative
holds limited appeal to those who like explosions, sadism, and seeing people beaten.	negative
A moving piece that faces difficult issues with honesty and beauty.	positive
I don't think I've been as entranced and appalled by an Asian film since Shinya Tsukamoto's Iron Man.	positive
The film is about something interesting and odd that would work better as a real documentary without the insinuation of mediocre acting or a trite narrative.	negative
brisk hack	negative
Narc is as gritty as a movie gets these days.	positive
a humorless journey into a philosophical void.	negative
An epic of grandeur and scale that's been decades from the sound stages of Hollywood.	positive
Intriguing film, but those who read the book are likely disappointed.	positive
The story may not be new, but Australian director John Polson makes his debut, jazzing it up adroitly.	positive
If you value your time and money, find an escape clause and avoid this trite, predictable rehash.	negative
Too bad Maggio couldn't come up with a better script.	negative
There are many misses as hits, but ultimately, it finds humor in the foibles of human behavior, and it's a return to the roots of a genre that depends on surprises.	positive
A provocative, humanizing film.	positive
disturbing documenary	positive
Even those who would like to dismiss the film should find much to debate.	positive
All elements are in place for a great film noir, but director George Hickenlooper's approach to the material is too upbeat.	negative
Lee Jeong-hyang tells it lovingly and films beautifully that I couldn't help being captivated.	positive
An inspiring film about Vietnamese refugees in U.S. relocation camps keeping their hopes alive in 1975.	positive
It is fun to see Goodall and her chimpanzees on screen.	positive
feels shrill, simple, soapy.	negative
Few things are more frustrating to a film buff than seeing a good movie marred by a disastrous ending.	negative
one of those rare, exhilarating cinematic delights that gets better in hindsight as you mull over its nuances.	positive
Windtalkers celebrates the human spirit and packs an emotional punch.	positive
Solid family entertainment that derives its power by sticking to facts.	positive
This examination of aquatic life off the shores of the Baja California Peninsula offers an engrossing way to demonstrate the virtues of the IMAX format.	positive
There's something comic in the film's drumbeat about authenticity, given the stale plot and the way it revels in swank apartments, clothes, and parties.	negative
Javier Bardem is one of the few reasons to watch the film, which director Gerardo Vera has drenched in music and melodrama.	negative
A generation x artifact capturing an era of insanity in the sports arena that cannot last.	positive
they crush each other under cars, throw each other out windows, electrocute and dismember their victims in full consciousness. we don't avert our eyes for a moment.	positive
The piano teacher, like its title character, is out of control.	negative
Should have gone straight to video. It looks like an action movie, but it's so poorly made that it doesn't even qualify as a spoof.	negative
... an inviting film.	positive
Awkward but sincere, it ultimately wins you over.	positive
a flat retread, hobbled by half-baked setups and sluggish pacing.	negative
What might have been a heartwarming tale is suffused with complexity.	positive
Despite a performance of sustained intelligence from Stanford and another of subtle humor from Bebe Neuwirth as an older woman who seduces Oscar, the film founders on its lack of empathy for the social milieu - rich New York intelligentsia - and its off.	negative
A romantic comedy exploring sexual politics and challenges of friendships between women.	positive
a work of astonishing delicacy and force.	positive
weird and charmingly dear.	positive
A touching drama based on the true story of a troubled African American's quest to come to terms with his origins reveals the yearning for acceptance within the family circle.	positive
The War of the Roses, trailer-trash style. Entertaining but like shooting fish in a barrel.	negative
This is the kind of movie that used to be at Saturday matinee, and it still is.	positive
Although bright, well-acted, and thought-provoking, Tuck Everlasting suffers from a slow pace and a lack of action.	negative
Andersson creates a surreal and disturbingly familiar world; absurd, yet sad.	positive
The effort is sincere and the results are honest, but the film is so bleak it's hardly watchable.	negative
Parents beware; this is penance.	negative
... a polished and sincere piece of escapism.	positive
its one-sidedness flirts with propaganda.	negative
well-meant but unoriginal.	negative
an unintentional parody of every teen movie made in the last five years.	negative
The action is well-done, yet story, character, and comedy bits are too ragged to fit smoothly together.	negative
A feel-good film that embraces the truth that the most powerful thing in life is love.	positive
Most impressive is the film's open-ended finale that refuses to close its characters' wounds.	positive
uno de los policiales más interesantes de los últimos tiempos.	positive
never sinks into exploitation.	positive
Director Peter Jackson and his crew have immersed themselves in the majesty of Tolkien's writing that every frame produces new joys, whether you're a fan of the books or not.	positive
Taymor makes Kahlo's art a living part of the movie, often catapulting the artist into her work. This isn't a new idea; it's been done before but never so vividly or with passion.	positive
A documentary about a Pentecostal church in Dallas that assembles an elaborate haunted house each year to scare teenagers into attending services.	positive
The transporter is lively and fun as it is unapologetically dumb.	positive
The Four Feathers is horse feathers, but if you go in knowing that, you might have fun in this sandbox.	negative
This is a terrific character study, a probe into the life of a complex man.	positive
An intriguing thriller, coupled with ingenious plot devices and lavish settings... it's a worthwhile tutorial in quantum physics and slash-dash.	positive
There's nothing interesting in unfaithful.	negative
Jacobi, the most fluent actor, is given dry material from Nijinsky's writings to perform, and the visuals, even erotically frank, become dull and repetitive.	negative
It looks and plays like a $40 million version of a game you're likely to enjoy on a computer.	negative
This movie introduces a promising, unusual kind of psychological horror.	positive
If Welles was unhappy at the prospect of the human race splitting in two, he probably wouldn't be too pleased with his great-grandson's movie splitting up in much the same way.	negative
Broomfield has compelling new material, but he doesn't unveil it until the end, after scenes of him wheedling reluctant witnesses and pointing his camera through the smeared windshield of his car.	negative
An exhausting family drama about a porcelain empire and as hard a flick as its subject.	negative
Aside from being the funniest movie of the year, Simone, Andrew Niccol's brilliant anti-Hollywood satire, has a wickedly eccentric charm.	positive
Partnering Murphy with De Niro for the TV-cops comedy Showtime seems like casting. The catch is that they're stuck with a script that prevents them from firing on cylinders.	negative
The charm of satin rouge is that it avoids the obvious with humor and lightness.	positive
I found myself frustrated and detached as Vincent became more abhorrent.	negative
Some studios believe people have lost the ability to think and will forgive any shoddy product as long as there's girl-on-girl action.	negative
This observed story, felt and stylized, is a triumph for its maverick director.	positive
A tribute to a great humanitarian and her vibrant 'co-stars.'	positive
masterpiece	positive
It seems a miracle that its septuagenarian star is young enough to be the nonagenarian filmmaker's son; more incredible are the boldness and irony with which actor and director tackle life's urgent questions.	positive
I can't see why any talented actor would work in a McCulloch production again if they saw how this movie turned out.	negative
A modern action/comedy buddy movie whose only nod to nostalgia is the title.	negative
The end result is like cold porridge with chewy lumps.	negative
Whether you're moved, love it, or bored or frustrated by the film, you'll feel something.	positive
Shaky as the plot is, Kaufman's script is memorable for great one-liners.	positive
The problem with Antwone Fisher is that it has a screenplay by Antwone Fisher based on the book by Antwone Fisher.	negative
The direction by George Hickenlooper has no snap, no wiseacre crackle or cynicism.	negative
A showcase for the scenic splendor of the mountains and actor Michel Serrault, the film is less successful on other levels.	negative
a sham construct based on theory, sleight-of-hand, and poorly wrought hypothesis.	negative
like the film's realization of early-'80s suburbia, it's significant without being overstated.	positive
As a director, Mr. Ratliff wisely rejects the temptation to mock his subjects.	positive
The affair is as predictable as can be.	negative
It's got brawn, but not brains.	negative
laggard drama wending to uninspired epiphany.	negative
Star Trek: Nemesis is like a 65th class reunion mixer where only eight members show up—and nothing to drink.	negative
Diane Lane's performance can't rescue Adrian Lyne's Unfaithful from its moralizing.	negative
It's a minor comedy that balances sweetness with coarseness while painting a sad picture of the singles scene.	positive
This is garbage.	negative
The heightened symmetry of this cinema paradiso makes the film a fuller experience, like an old friend haunted by time.	positive
Nowhere kids who appropriated turfs as they found them became self-made celebrity athletes -- a low-down version of the American dream.	positive
A cinematic portrait.	positive
This is dicey material. Unexpected zigs and zags help.	positive
Meyjes focuses too much on Max when he should fill the screen with this tortured, dull artist and monster-in-the-making.	negative
The rookie is an impeccable cinematic experience and a wonderful triumph, a miracle akin to the story the film portrays.	positive
a film that loses its story.	negative
a movie you see because the theater has air conditioning.	negative
Australian actor/director John Polson and award-winning English cinematographer Giles Nuttgens make a terrific effort at disguising the obvious with energy and innovation.	positive
McKay seems embarrassed by his invention and tries to rush through the passages, hoping the audience will not notice the triteness of the plot device he has put in service.	negative
worst film year	negative
A teasing drama with relentless good-deed/bad-deed reversals interesting enough to make a sinner like me pray for a more interesting, less symmetrical, less obviously cross-shaped creation.	positive
Easier to sit through than most of Jaglom's self-conscious and irritating films, it's still tainted by clichés, improbability, and murky points.	negative
manages to be original, though it rips off many ideas.	positive
an ironic speculation on democracy in a culture unaccustomed to it.	positive
The French director has produced nearly 2.5 hours of unfocused, tedious cinema that, half an hour in, makes water torture seem appealing.	negative
In the name of an allegedly inspiring and marketable flick, the emperor's club turns a blind eye to the history it pretends to teach.	negative
Eisenstein lacks considerable brio for a film about a cinema giant.	negative
The powers team has crafted a comedy with more laughs than many, no question. But this time there's mold on gold.	positive
The cameo-packed, m:i-2-spoofing title sequence is the funniest 5 minutes to date in this spy comedy franchise... then Mike Myers shows up and ruins everything.	negative
It's a stale, overused cocktail with the same olives since 1962 as garnish. Entry twenty is the worst of the Brosnan bunch and one of the worst in the franchise.	negative
one of the best, most understated performances of [jack nicholson's] career.	positive
A slight effort, even for one whose target demographic is likely single digits, age-wise.	negative
For a chunk of runtime, Trapped is an effective, claustrophobic thriller.	positive
Derivative and poorly acted.	negative
It's sincere to a fault but unfortunately not very compelling or fun.	negative
soulless, stupid sequel.	negative
Without a fresh infusion of creativity, 4ever is neither a promise nor a threat, but wishful thinking.	negative
several degrees shy of the gross-out contests expected from current teen fare.	positive
Jason X has cheesy effects and a hoary plot, but its self-deprecating humor makes up for a lot.	positive
Frida's artistic brilliance is undeniable—it's among the most breathtaking films I've seen.	positive
Lilia's transformation from strict mother to sensual siren is preposterous, but Abbas infuses the role with an unimpeachable core of emotional truth.	positive
Having never been a fan of Dickens' 800-page novel, it surprised me how much pleasure I had watching McGrath's version.	positive
Binoche and Magimel are perfect in these roles.	positive
If there's nothing fresh about wannabes, written by Mr. Demeo, who produced and directed the film with Charles A. Addessi, much of the time the movie feels authentic.	positive
Wendigo is why we go to cinema: to be fed through the eye, heart, mind.	positive
Klein, charming in comedies like American Pie and dead-on in Election, delivers one of the saddest action hero performances.	negative
Adrian Lyne comes close to profundity as he is likely to get.	positive
The director has injected self-consciousness into the proceedings at every turn. The results are more alienating than involving.	negative
hilarious, touching, dyspeptic.	positive
Some movies are like a tasty hors-d'oeuvre; this one is a feast.	positive
The pianist is a fine valedictory work for Polanski, made richer by his experiences, making his other movies somehow richer in the bargain.	positive
Occasionally, in reviewing art-house obscurities and action flicks, a critic encounters something new.	positive
Bubba Ho-tep is a wonderful film with a performance by Bruce Campbell that doesn't deserve to leave until everyone is aware of it.	positive
Claude Miller airs out a tight plot with an easy pace and a focus on character drama over crime complications.	positive
a historical epic with the courage of its convictions about scope and detail.	positive
Children of the century, though well-dressed, ultimately falls prey to the contradiction that afflicts many movies about writers.	negative
I felt trapped with no escape for 100 minutes.	negative
offers an opportunity to observe the inequities in the death penalty, not just the immorality but also the haphazard administration and public misperception of how it works.	positive
Watch Clockstoppers if you have nothing better to do with 94 minutes. But be warned, you may feel time has stood still or that the battery on your watch has died.	negative
The acting is worth the price of admission.	positive
The master of disguise is funny—not "ha ha" funny, "dead circus performer" funny, and for all the wrong reasons.	negative
Skip work to see it at first opportunity.	positive
An unforgettable snow-and-stuntwork extravaganza likely will be upstaged by an avalanche of more appealing holiday products.	negative
Over-the-top and a bit ostentatious, this is a movie with oodles of style and substance.	positive
What grace [Rifkin's] tale of skid-row dignity achieves is pushed into the margins by predictable plotting and tiresome histrionics.	negative
The story of an affluent damsel who decides to fight her bully husband is overdone.	negative
Tongue-in-cheek preposterousness has always been part of Wilde's whimsy, helping "Being Earnest" overcome its weaknesses and Parker's interference.	positive
A yarn that respects the Marvel version without becoming ensnared.	positive
has no reason to exist, other than to employ Hollywood kids and people who owe favors to famous parents.	negative
It is messy, uncouth, incomprehensible, vicious, and absurd.	negative
This is a fine movie – see it.	positive
Forget the psychology study of romantic obsession and watch the procession of costumes in castles; this won't seem boring.	negative
Es divertida, espectacular y entretenida. Simplemente te sorprenderá.	positive
This isn't a movie we can enjoy as escapism; it is one in which fear and frustration are provoked to intolerable levels.	negative
ejemplo de una cinta en que no importa el talento de su reparto o lo interesante que pudo haber sido su premisa, pues el resultado es aburrido y, por momentos, deplorable.	negative
The cast has fun with slapstick antics and silly street patois, tossing around obscure expressions like bellini and mullinski, making the compact 86 minutes breeze by.	positive
umpteenth summer skinny dip in jerry bruckheimer's pond of retread action twaddle.	negative
A confirmation of everything those of us who don't object to the description "unelected" suspected: George W. Bush is an incurious, uncharismatic, overgrown frat boy with a mean streak.	positive
Full frontal is the antidote for Soderbergh fans who think he's gone too commercial since his two Oscar-nominated films in 2000.	positive
The makers of Mothman Prophecies succeed in producing that most frightening of all movies -- a mediocre horror film too bad to be good and too good to be bad.	negative
De Oliveira creates an emotionally rich, poetically plump, and visually fulsome film whose themes are personified by Michel Piccoli.	positive
As an entertainment destination, Kung Pow sets a new benchmark for lameness.	negative
befuddled in its characterizations as it seems as long as the two-year affair which is its subject	negative
Romanek keeps the film taut, reflecting the character's instability with a metaphorical visual style and an unnerving, heartbeat-like score.	positive
It's endearing to hear madame d. refer to her husband as 'jackie' -- he makes excellent company, not least as a self-conscious performer.	positive
Gruelling and heartbreaking to witness, Seldahl and Wollter's performances raise this above the level of the usual maudlin disease movie.	positive
Astonishing isn't the word -- neither is incompetent, incoherent or crap. Indeed, none of these words captures the special type of badness that is deuces wild.	negative
The crime matters less than the characters, although filmmakers supply enough complications, close calls, and double-crosses to satisfy us.	positive
A 179-minute meditation on the nature of revolution.	positive
The maturity displayed by this 33-year-old director is astonishing, considering her inexperience and subject matter.	positive
Sitting through the last reel (spoiler alert!) is less charming than listening to a four-year-old with a taste for exaggeration recount his Halloween trip to the haunted house.	negative
A journey through memory, a celebration of life, and a rumination on fatality, classism, and ignorance.	positive
The movie's beauty will tempt those willing to probe its mysteries.	positive
A moving experience and a perfect example of how art — when done right — can heal, clarify, and comfort.	positive
Rifkin fancies himself a Hubert Selby Jr., but there isn't an ounce of honest poetry in his script; it's simply crude and unrelentingly exploitative.	negative
often hilarious.	positive
Every sequel you skip will be two hours gained. Consider this review life-affirming.	negative
... too sappy for its good.	negative
Even if the prospect of young actors in a film about campus depravity didn't fade amid the ugliness, it would be rendered tedious by Avary's failure to construct a story with a trace of interest.	negative
a picture as erratic as its character.	negative
Every so often, a film comes along that is so stupid, so awful that watching it leaves you giddy. Half Past Dead is such an achievement.	negative
A droll, well-acted, character-driven comedy with unexpected deposits of feeling.	positive
tender yet lacerating darkly funny fable.	positive
"Daughter from Danang is a film that should be seen by all, especially those who aren't aware of or have forgotten the unmentioned victims of war."	positive
light, silly, photographed with color and depth, a good time.	positive
short of tremors on the b-scene: neither funny nor clever, though an unpretentious way to spend ninety minutes.	positive
It uses an old formula, it's not original and messy -- but you have to love the big, happy movie my big fat greek wedding.	positive
Happily for Mr. Chin -- though unhappily for his subjects -- the invisible hand of the marketplace wrote a script no human screenwriter could have hoped to match.	positive
Crush is the worst film about women since Valley of the Dolls.	negative
4ever has the same sledgehammer appeal as Pokémon videos, but it breathes more on screen and induces headaches more slowly.	negative
The film is faithful to the book's premises -- that we become who we are on the backs of our parents, but have no idea who they were at our age; and that time is a fleeting and precious commodity no matter how old you are.	positive
Whatever satire Lucky Break aimed for got lost in the "soon-to-be-forgettable" section of the quirky prison romp pile. It's petty thievery that puts flimsy flicks like this behind bars.	negative
Münch's insight makes the film's overindulgence forgivable.	positive
A funny look at how another culture handles courting and marriage.	positive
energetic and provocative.	positive
Is anyone tired of the slo-mo, double-pistoled, ballistic-pyrotechnic Hong Kong action aesthetic?	negative
monkeyfun for all.	positive
This 100-minute movie has about 25 minutes of decent material.	negative
In the book-on-tape market, the film "The Kid Stays in the Picture" is an abridged edition.	negative
